DAY,MONTH,YEAR,FLIGHT_CATEGORY,INBOUND_FLIGHTS,OUTBOUND_FLIGHTS,TOTAL_FLIGHTS
1,JAN,2012,INTERNATIONAL FLIGHTS,9,10,19
2,JAN,2012,INTERNATIONAL FLIGHTS,6,7,13
3,JAN,2012,INTERNATIONAL FLIGHTS,4,3,7
4,JAN,2012,INTERNATIONAL FLIGHTS,24,21,45
5,JAN,2012,INTERNATIONAL FLIGHTS,5,4,9
6,JAN,2012,INTERNATIONAL FLIGHTS,10,7,17
7,JAN,2012,INTERNATIONAL FLIGHTS,5,7,12
8,JAN,2012,INTERNATIONAL FLIGHTS,10,10,20
9,JAN,2012,INTERNATIONAL FLIGHTS,5,5,10
10,JAN,2012,INTERNATIONAL FLIGHTS,3,3,6
11,JAN,2012,INTERNATIONAL FLIGHTS,12,13,25
12,JAN,2012,INTERNATIONAL FLIGHTS,4,4,8
13,JAN,2012,INTERNATIONAL FLIGHTS,4,5,9
14,JAN,2012,INTERNATIONAL FLIGHTS,6,4,10
15,JAN,2012,INTERNATIONAL FLIGHTS,10,10,20
16,JAN,2012,INTERNATIONAL FLIGHTS,7,7,14
17,JAN,2012,INTERNATIONAL FLIGHTS,2,2,4
18,JAN,2012,INTERNATIONAL FLIGHTS,13,13,26
19,JAN,2012,INTERNATIONAL FLIGHTS,9,7,16
20,JAN,2012,INTERNATIONAL FLIGHTS,5,6,11
21,JAN,2012,INTERNATIONAL FLIGHTS,6,6,12
22,JAN,2012,INTERNATIONAL FLIGHTS,11,10,21
23,JAN,2012,INTERNATIONAL FLIGHTS,8,7,15
24,JAN,2012,INTERNATIONAL FLIGHTS,0,3,3
25,JAN,2012,INTERNATIONAL FLIGHTS,14,14,28
26,JAN,2012,INTERNATIONAL FLIGHTS,5,4,9
27,JAN,2012,INTERNATIONAL FLIGHTS,3,1,4
28,JAN,2012,INTERNATIONAL FLIGHTS,6,6,12
29,JAN,2012,INTERNATIONAL FLIGHTS,10,12,22
30,JAN,2012,INTERNATIONAL FLIGHTS,5,4,9
31,JAN,2012,INTERNATIONAL FLIGHTS,6,5,11
1,JAN,2012,LOCAL FLIGHTS,0,0,0
2,JAN,2012,LOCAL FLIGHTS,1,1,2
3,JAN,2012,LOCAL FLIGHTS,3,3,6
4,JAN,2012,LOCAL FLIGHTS,3,3,6
5,JAN,2012,LOCAL FLIGHTS,3,3,6
6,JAN,2012,LOCAL FLIGHTS,0,0,0
7,JAN,2012,LOCAL FLIGHTS,0,0,0
8,JAN,2012,LOCAL FLIGHTS,0,0,0
9,JAN,2012,LOCAL FLIGHTS,5,5,10
10,JAN,2012,LOCAL FLIGHTS,4,4,8
11,JAN,2012,LOCAL FLIGHTS,1,1,2
12,JAN,2012,LOCAL FLIGHTS,3,3,6
13,JAN,2012,LOCAL FLIGHTS,6,6,12
14,JAN,2012,LOCAL FLIGHTS,8,8,16
15,JAN,2012,LOCAL FLIGHTS,7,7,14
16,JAN,2012,LOCAL FLIGHTS,5,6,11
17,JAN,2012,LOCAL FLIGHTS,4,4,8
18,JAN,2012,LOCAL FLIGHTS,7,7,14
19,JAN,2012,LOCAL FLIGHTS,8,8,16
20,JAN,2012,LOCAL FLIGHTS,3,3,6
21,JAN,2012,LOCAL FLIGHTS,3,3,6
22,JAN,2012,LOCAL FLIGHTS,3,3,6
23,JAN,2012,LOCAL FLIGHTS,5,4,9
24,JAN,2012,LOCAL FLIGHTS,4,4,8
25,JAN,2012,LOCAL FLIGHTS,1,1,2
26,JAN,2012,LOCAL FLIGHTS,0,0,0
27,JAN,2012,LOCAL FLIGHTS,1,1,2
28,JAN,2012,LOCAL FLIGHTS,0,0,0
29,JAN,2012,LOCAL FLIGHTS,0,0,0
30,JAN,2012,LOCAL FLIGHTS,1,1,2
31,JAN,2012,LOCAL FLIGHTS,2,2,4
1,JAN,2012,HELICOPTER FLIGHTS,0,0,0
2,JAN,2012,HELICOPTER FLIGHTS,0,0,0
3,JAN,2012,HELICOPTER FLIGHTS,3,3,6
4,JAN,2012,HELICOPTER FLIGHTS,3,3,6
5,JAN,2012,HELICOPTER FLIGHTS,1,1,2
6,JAN,2012,HELICOPTER FLIGHTS,0,0,0
7,JAN,2012,HELICOPTER FLIGHTS,0,0,0
8,JAN,2012,HELICOPTER FLIGHTS,0,0,0
9,JAN,2012,HELICOPTER FLIGHTS,5,5,10
10,JAN,2012,HELICOPTER FLIGHTS,3,3,6
11,JAN,2012,HELICOPTER FLIGHTS,3,3,6
12,JAN,2012,HELICOPTER FLIGHTS,1,1,2
13,JAN,2012,HELICOPTER FLIGHTS,0,0,0
14,JAN,2012,HELICOPTER FLIGHTS,0,0,0
15,JAN,2012,HELICOPTER FLIGHTS,3,3,6
16,JAN,2012,HELICOPTER FLIGHTS,3,3,6
17,JAN,2012,HELICOPTER FLIGHTS,7,7,14
18,JAN,2012,HELICOPTER FLIGHTS,4,4,8
19,JAN,2012,HELICOPTER FLIGHTS,8,8,16
20,JAN,2012,HELICOPTER FLIGHTS,0,0,0
21,JAN,2012,HELICOPTER FLIGHTS,0,0,0
22,JAN,2012,HELICOPTER FLIGHTS,0,0,0
23,JAN,2012,HELICOPTER FLIGHTS,8,8,16
24,JAN,2012,HELICOPTER FLIGHTS,5,5,10
25,JAN,2012,HELICOPTER FLIGHTS,0,0,0
26,JAN,2012,HELICOPTER FLIGHTS,0,0,0
27,JAN,2012,HELICOPTER FLIGHTS,1,1,2
28,JAN,2012,HELICOPTER FLIGHTS,0,0,0
29,JAN,2012,HELICOPTER FLIGHTS,0,0,0
30,JAN,2012,HELICOPTER FLIGHTS,10,10,20
31,JAN,2012,HELICOPTER FLIGHTS,9,9,18
1,FEB,2012,INTERNATIONAL FLIGHTS,17,16,33
2,FEB,2012,INTERNATIONAL FLIGHTS,6,8,14
3,FEB,2012,INTERNATIONAL FLIGHTS,7,6,13
4,FEB,2012,INTERNATIONAL FLIGHTS,5,6,11
5,FEB,2012,INTERNATIONAL FLIGHTS,13,11,24
6,FEB,2012,INTERNATIONAL FLIGHTS,7,8,15
7,FEB,2012,INTERNATIONAL FLIGHTS,3,4,7
8,FEB,2012,INTERNATIONAL FLIGHTS,15,13,28
9,FEB,2012,INTERNATIONAL FLIGHTS,6,7,13
10,FEB,2012,INTERNATIONAL FLIGHTS,7,7,14
11,FEB,2012,INTERNATIONAL FLIGHTS,4,4,8
12,FEB,2012,INTERNATIONAL FLIGHTS,13,12,25
13,FEB,2012,INTERNATIONAL FLIGHTS,8,7,15
14,FEB,2012,INTERNATIONAL FLIGHTS,2,3,5
15,FEB,2012,INTERNATIONAL FLIGHTS,14,15,29
16,FEB,2012,INTERNATIONAL FLIGHTS,6,5,11
17,FEB,2012,INTERNATIONAL FLIGHTS,6,5,11
18,FEB,2012,INTERNATIONAL FLIGHTS,6,6,12
19,FEB,2012,INTERNATIONAL FLIGHTS,13,14,27
20,FEB,2012,INTERNATIONAL FLIGHTS,6,8,14
21,FEB,2012,INTERNATIONAL FLIGHTS,1,3,4
22,FEB,2012,INTERNATIONAL FLIGHTS,15,14,29
23,FEB,2012,INTERNATIONAL FLIGHTS,7,6,13
24,FEB,2012,INTERNATIONAL FLIGHTS,6,6,12
25,FEB,2012,INTERNATIONAL FLIGHTS,8,10,18
26,FEB,2012,INTERNATIONAL FLIGHTS,14,14,28
27,FEB,2012,INTERNATIONAL FLIGHTS,7,7,14
28,FEB,2012,INTERNATIONAL FLIGHTS,3,2,5
29,FEB,2012,INTERNATIONAL FLIGHTS,13,12,25
1,FEB,2012,LOCAL FLIGHTS,7,7,14
2,FEB,2012,LOCAL FLIGHTS,9,9,18
3,FEB,2012,LOCAL FLIGHTS,8,7,15
4,FEB,2012,LOCAL FLIGHTS,4,4,8
5,FEB,2012,LOCAL FLIGHTS,4,3,7
6,FEB,2012,LOCAL FLIGHTS,4,5,9
7,FEB,2012,LOCAL FLIGHTS,3,3,6
8,FEB,2012,LOCAL FLIGHTS,6,6,12
9,FEB,2012,LOCAL FLIGHTS,3,3,6
10,FEB,2012,LOCAL FLIGHTS,7,8,15
11,FEB,2012,LOCAL FLIGHTS,11,10,21
12,FEB,2012,LOCAL FLIGHTS,0,0,0
13,FEB,2012,LOCAL FLIGHTS,4,4,8
14,FEB,2012,LOCAL FLIGHTS,4,2,6
15,FEB,2012,LOCAL FLIGHTS,4,4,8
16,FEB,2012,LOCAL FLIGHTS,0,0,0
17,FEB,2012,LOCAL FLIGHTS,0,0,0
18,FEB,2012,LOCAL FLIGHTS,0,0,0
19,FEB,2012,LOCAL FLIGHTS,2,2,4
20,FEB,2012,LOCAL FLIGHTS,8,8,16
21,FEB,2012,LOCAL FLIGHTS,10,10,20
22,FEB,2012,LOCAL FLIGHTS,12,12,24
23,FEB,2012,LOCAL FLIGHTS,4,4,8
24,FEB,2012,LOCAL FLIGHTS,7,7,14
25,FEB,2012,LOCAL FLIGHTS,4,4,8
26,FEB,2012,LOCAL FLIGHTS,0,0,0
27,FEB,2012,LOCAL FLIGHTS,1,1,2
28,FEB,2012,LOCAL FLIGHTS,0,0,0
29,FEB,2012,LOCAL FLIGHTS,0,0,0
1,FEB,2012,HELICOPTER FLIGHTS,9,9,18
2,FEB,2012,HELICOPTER FLIGHTS,9,9,18
3,FEB,2012,HELICOPTER FLIGHTS,2,2,4
4,FEB,2012,HELICOPTER FLIGHTS,0,0,0
5,FEB,2012,HELICOPTER FLIGHTS,0,0,0
6,FEB,2012,HELICOPTER FLIGHTS,14,14,28
7,FEB,2012,HELICOPTER FLIGHTS,3,3,6
8,FEB,2012,HELICOPTER FLIGHTS,10,10,20
9,FEB,2012,HELICOPTER FLIGHTS,11,11,22
10,FEB,2012,HELICOPTER FLIGHTS,0,0,0
11,FEB,2012,HELICOPTER FLIGHTS,0,0,0
12,FEB,2012,HELICOPTER FLIGHTS,0,0,0
13,FEB,2012,HELICOPTER FLIGHTS,12,12,24
14,FEB,2012,HELICOPTER FLIGHTS,6,6,12
15,FEB,2012,HELICOPTER FLIGHTS,3,3,6
16,FEB,2012,HELICOPTER FLIGHTS,2,2,4
17,FEB,2012,HELICOPTER FLIGHTS,0,0,0
18,FEB,2012,HELICOPTER FLIGHTS,0,0,0
19,FEB,2012,HELICOPTER FLIGHTS,0,0,0
20,FEB,2012,HELICOPTER FLIGHTS,8,8,16
21,FEB,2012,HELICOPTER FLIGHTS,7,7,14
22,FEB,2012,HELICOPTER FLIGHTS,7,7,14
23,FEB,2012,HELICOPTER FLIGHTS,2,2,4
24,FEB,2012,HELICOPTER FLIGHTS,1,1,2
25,FEB,2012,HELICOPTER FLIGHTS,0,0,0
26,FEB,2012,HELICOPTER FLIGHTS,1,1,2
27,FEB,2012,HELICOPTER FLIGHTS,0,0,0
28,FEB,2012,HELICOPTER FLIGHTS,0,0,0
29,FEB,2012,HELICOPTER FLIGHTS,0,0,0
1,MAR,2012,INTERNATIONAL FLIGHTS,7,5,12
2,MAR,2012,INTERNATIONAL FLIGHTS,7,8,15
3,MAR,2012,INTERNATIONAL FLIGHTS,7,6,13
4,MAR,2012,INTERNATIONAL FLIGHTS,13,16,29
5,MAR,2012,INTERNATIONAL FLIGHTS,9,8,17
6,MAR,2012,INTERNATIONAL FLIGHTS,3,4,7
7,MAR,2012,INTERNATIONAL FLIGHTS,18,18,36
8,MAR,2012,INTERNATIONAL FLIGHTS,7,6,13
9,MAR,2012,INTERNATIONAL FLIGHTS,11,12,23
10,MAR,2012,INTERNATIONAL FLIGHTS,5,5,10
11,MAR,2012,INTERNATIONAL FLIGHTS,14,14,28
12,MAR,2012,INTERNATIONAL FLIGHTS,8,8,16
13,MAR,2012,INTERNATIONAL FLIGHTS,2,4,6
14,MAR,2012,INTERNATIONAL FLIGHTS,18,20,38
15,MAR,2012,INTERNATIONAL FLIGHTS,7,8,15
16,MAR,2012,INTERNATIONAL FLIGHTS,8,9,17
17,MAR,2012,INTERNATIONAL FLIGHTS,6,5,11
18,MAR,2012,INTERNATIONAL FLIGHTS,15,15,30
19,MAR,2012,INTERNATIONAL FLIGHTS,7,6,13
20,MAR,2012,INTERNATIONAL FLIGHTS,3,4,7
21,MAR,2012,INTERNATIONAL FLIGHTS,19,22,41
22,MAR,2012,INTERNATIONAL FLIGHTS,7,5,12
23,MAR,2012,INTERNATIONAL FLIGHTS,11,13,24
24,MAR,2012,INTERNATIONAL FLIGHTS,6,5,11
25,MAR,2012,INTERNATIONAL FLIGHTS,19,19,38
26,MAR,2012,INTERNATIONAL FLIGHTS,12,11,23
27,MAR,2012,INTERNATIONAL FLIGHTS,9,9,18
28,MAR,2012,INTERNATIONAL FLIGHTS,26,26,52
29,MAR,2012,INTERNATIONAL FLIGHTS,6,6,12
30,MAR,2012,INTERNATIONAL FLIGHTS,10,12,22
31,MAR,2012,INTERNATIONAL FLIGHTS,16,14,30
1,MAR,2012,LOCAL FLIGHTS,2,2,4
2,MAR,2012,LOCAL FLIGHTS,2,2,4
3,MAR,2012,LOCAL FLIGHTS,6,6,12
4,MAR,2012,LOCAL FLIGHTS,1,1,2
5,MAR,2012,LOCAL FLIGHTS,6,6,12
6,MAR,2012,LOCAL FLIGHTS,6,5,11
7,MAR,2012,LOCAL FLIGHTS,4,4,8
8,MAR,2012,LOCAL FLIGHTS,7,7,14
9,MAR,2012,LOCAL FLIGHTS,13,12,25
10,MAR,2012,LOCAL FLIGHTS,9,9,18
11,MAR,2012,LOCAL FLIGHTS,1,1,2
12,MAR,2012,LOCAL FLIGHTS,4,5,9
13,MAR,2012,LOCAL FLIGHTS,4,5,9
14,MAR,2012,LOCAL FLIGHTS,0,0,0
15,MAR,2012,LOCAL FLIGHTS,11,11,22
16,MAR,2012,LOCAL FLIGHTS,4,2,6
17,MAR,2012,LOCAL FLIGHTS,8,8,16
18,MAR,2012,LOCAL FLIGHTS,0,0,0
19,MAR,2012,LOCAL FLIGHTS,3,3,6
20,MAR,2012,LOCAL FLIGHTS,7,7,14
21,MAR,2012,LOCAL FLIGHTS,8,8,16
22,MAR,2012,LOCAL FLIGHTS,7,7,14
23,MAR,2012,LOCAL FLIGHTS,4,4,8
24,MAR,2012,LOCAL FLIGHTS,5,5,10
25,MAR,2012,LOCAL FLIGHTS,0,0,0
26,MAR,2012,LOCAL FLIGHTS,5,5,10
27,MAR,2012,LOCAL FLIGHTS,4,4,8
28,MAR,2012,LOCAL FLIGHTS,3,3,6
29,MAR,2012,LOCAL FLIGHTS,7,7,14
30,MAR,2012,LOCAL FLIGHTS,6,6,12
31,MAR,2012,LOCAL FLIGHTS,6,6,12
1,MAR,2012,HELICOPTER FLIGHTS,10,10,20
2,MAR,2012,HELICOPTER FLIGHTS,2,2,4
3,MAR,2012,HELICOPTER FLIGHTS,0,0,0
4,MAR,2012,HELICOPTER FLIGHTS,0,0,0
5,MAR,2012,HELICOPTER FLIGHTS,12,12,24
6,MAR,2012,HELICOPTER FLIGHTS,3,3,6
7,MAR,2012,HELICOPTER FLIGHTS,5,5,10
8,MAR,2012,HELICOPTER FLIGHTS,2,2,4
9,MAR,2012,HELICOPTER FLIGHTS,0,0,0
10,MAR,2012,HELICOPTER FLIGHTS,1,1,2
11,MAR,2012,HELICOPTER FLIGHTS,0,0,0
12,MAR,2012,HELICOPTER FLIGHTS,6,6,12
13,MAR,2012,HELICOPTER FLIGHTS,5,5,10
14,MAR,2012,HELICOPTER FLIGHTS,0,0,0
15,MAR,2012,HELICOPTER FLIGHTS,4,4,8
16,MAR,2012,HELICOPTER FLIGHTS,0,0,0
17,MAR,2012,HELICOPTER FLIGHTS,0,0,0
18,MAR,2012,HELICOPTER FLIGHTS,0,0,0
19,MAR,2012,HELICOPTER FLIGHTS,6,6,12
20,MAR,2012,HELICOPTER FLIGHTS,6,6,12
21,MAR,2012,HELICOPTER FLIGHTS,2,2,4
22,MAR,2012,HELICOPTER FLIGHTS,5,5,10
23,MAR,2012,HELICOPTER FLIGHTS,0,0,0
24,MAR,2012,HELICOPTER FLIGHTS,0,0,0
25,MAR,2012,HELICOPTER FLIGHTS,0,0,0
26,MAR,2012,HELICOPTER FLIGHTS,14,15,29
27,MAR,2012,HELICOPTER FLIGHTS,5,5,10
28,MAR,2012,HELICOPTER FLIGHTS,7,6,13
29,MAR,2012,HELICOPTER FLIGHTS,3,3,6
30,MAR,2012,HELICOPTER FLIGHTS,1,1,2
31,MAR,2012,HELICOPTER FLIGHTS,0,0,0
1,APR,2012,INTERNATIONAL FLIGHTS,29,27,56
2,APR,2012,INTERNATIONAL FLIGHTS,10,11,21
3,APR,2012,INTERNATIONAL FLIGHTS,14,12,26
4,APR,2012,INTERNATIONAL FLIGHTS,38,36,74
5,APR,2012,INTERNATIONAL FLIGHTS,13,13,26
6,APR,2012,INTERNATIONAL FLIGHTS,17,13,30
7,APR,2012,INTERNATIONAL FLIGHTS,18,19,37
8,APR,2012,INTERNATIONAL FLIGHTS,30,31,61
9,APR,2012,INTERNATIONAL FLIGHTS,13,15,28
10,APR,2012,INTERNATIONAL FLIGHTS,13,13,26
11,APR,2012,INTERNATIONAL FLIGHTS,37,38,75
12,APR,2012,INTERNATIONAL FLIGHTS,12,13,25
13,APR,2012,INTERNATIONAL FLIGHTS,13,13,26
14,APR,2012,INTERNATIONAL FLIGHTS,20,20,40
15,APR,2012,INTERNATIONAL FLIGHTS,30,30,60
16,APR,2012,INTERNATIONAL FLIGHTS,18,15,33
17,APR,2012,INTERNATIONAL FLIGHTS,14,15,29
18,APR,2012,INTERNATIONAL FLIGHTS,36,35,71
19,APR,2012,INTERNATIONAL FLIGHTS,11,13,24
20,APR,2012,INTERNATIONAL FLIGHTS,13,13,26
21,APR,2012,INTERNATIONAL FLIGHTS,20,19,39
22,APR,2012,INTERNATIONAL FLIGHTS,29,30,59
23,APR,2012,INTERNATIONAL FLIGHTS,13,12,25
24,APR,2012,INTERNATIONAL FLIGHTS,15,13,28
25,APR,2012,INTERNATIONAL FLIGHTS,38,39,77
26,APR,2012,INTERNATIONAL FLIGHTS,13,12,25
27,APR,2012,INTERNATIONAL FLIGHTS,18,16,34
28,APR,2012,INTERNATIONAL FLIGHTS,28,29,57
29,APR,2012,INTERNATIONAL FLIGHTS,35,35,70
30,APR,2012,INTERNATIONAL FLIGHTS,15,15,30
1,APR,2012,LOCAL FLIGHTS,1,1,2
2,APR,2012,LOCAL FLIGHTS,5,5,10
3,APR,2012,LOCAL FLIGHTS,6,6,12
4,APR,2012,LOCAL FLIGHTS,8,8,16
5,APR,2012,LOCAL FLIGHTS,8,8,16
6,APR,2012,LOCAL FLIGHTS,4,4,8
7,APR,2012,LOCAL FLIGHTS,4,4,8
8,APR,2012,LOCAL FLIGHTS,0,0,0
9,APR,2012,LOCAL FLIGHTS,3,3,6
10,APR,2012,LOCAL FLIGHTS,2,1,3
11,APR,2012,LOCAL FLIGHTS,3,3,6
12,APR,2012,LOCAL FLIGHTS,5,5,10
13,APR,2012,LOCAL FLIGHTS,4,4,8
14,APR,2012,LOCAL FLIGHTS,1,1,2
15,APR,2012,LOCAL FLIGHTS,0,0,0
16,APR,2012,LOCAL FLIGHTS,0,0,0
17,APR,2012,LOCAL FLIGHTS,6,6,12
18,APR,2012,LOCAL FLIGHTS,1,2,3
19,APR,2012,LOCAL FLIGHTS,3,3,6
20,APR,2012,LOCAL FLIGHTS,1,1,2
21,APR,2012,LOCAL FLIGHTS,5,5,10
22,APR,2012,LOCAL FLIGHTS,2,2,4
23,APR,2012,LOCAL FLIGHTS,6,6,12
24,APR,2012,LOCAL FLIGHTS,6,6,12
25,APR,2012,LOCAL FLIGHTS,4,4,8
26,APR,2012,LOCAL FLIGHTS,8,9,17
27,APR,2012,LOCAL FLIGHTS,7,7,14
28,APR,2012,LOCAL FLIGHTS,4,4,8
29,APR,2012,LOCAL FLIGHTS,1,1,2
30,APR,2012,LOCAL FLIGHTS,6,5,11
1,APR,2012,HELICOPTER FLIGHTS,0,0,0
2,APR,2012,HELICOPTER FLIGHTS,9,9,18
3,APR,2012,HELICOPTER FLIGHTS,3,3,6
4,APR,2012,HELICOPTER FLIGHTS,4,4,8
5,APR,2012,HELICOPTER FLIGHTS,7,7,14
6,APR,2012,HELICOPTER FLIGHTS,4,4,8
7,APR,2012,HELICOPTER FLIGHTS,0,0,0
8,APR,2012,HELICOPTER FLIGHTS,0,0,0
9,APR,2012,HELICOPTER FLIGHTS,6,6,12
10,APR,2012,HELICOPTER FLIGHTS,0,0,0
11,APR,2012,HELICOPTER FLIGHTS,2,2,4
12,APR,2012,HELICOPTER FLIGHTS,1,0,1
13,APR,2012,HELICOPTER FLIGHTS,0,0,0
14,APR,2012,HELICOPTER FLIGHTS,0,0,0
15,APR,2012,HELICOPTER FLIGHTS,0,0,0
16,APR,2012,HELICOPTER FLIGHTS,0,0,0
17,APR,2012,HELICOPTER FLIGHTS,0,0,0
18,APR,2012,HELICOPTER FLIGHTS,1,1,2
19,APR,2012,HELICOPTER FLIGHTS,6,6,12
20,APR,2012,HELICOPTER FLIGHTS,7,8,15
21,APR,2012,HELICOPTER FLIGHTS,0,0,0
22,APR,2012,HELICOPTER FLIGHTS,0,0,0
23,APR,2012,HELICOPTER FLIGHTS,10,10,20
24,APR,2012,HELICOPTER FLIGHTS,8,8,16
25,APR,2012,HELICOPTER FLIGHTS,7,7,14
26,APR,2012,HELICOPTER FLIGHTS,3,3,6
27,APR,2012,HELICOPTER FLIGHTS,4,4,8
28,APR,2012,HELICOPTER FLIGHTS,0,0,0
29,APR,2012,HELICOPTER FLIGHTS,0,0,0
30,APR,2012,HELICOPTER FLIGHTS,1,1,2
1,MAY,2012,INTERNATIONAL FLIGHTS,17,18,35
2,MAY,2012,INTERNATIONAL FLIGHTS,46,43,89
3,MAY,2012,INTERNATIONAL FLIGHTS,17,16,33
4,MAY,2012,INTERNATIONAL FLIGHTS,26,25,51
5,MAY,2012,INTERNATIONAL FLIGHTS,36,36,72
6,MAY,2012,INTERNATIONAL FLIGHTS,50,51,101
7,MAY,2012,INTERNATIONAL FLIGHTS,18,19,37
8,MAY,2012,INTERNATIONAL FLIGHTS,22,23,45
9,MAY,2012,INTERNATIONAL FLIGHTS,46,45,91
10,MAY,2012,INTERNATIONAL FLIGHTS,16,15,31
11,MAY,2012,INTERNATIONAL FLIGHTS,18,18,36
12,MAY,2012,INTERNATIONAL FLIGHTS,35,34,69
13,MAY,2012,INTERNATIONAL FLIGHTS,40,41,81
14,MAY,2012,INTERNATIONAL FLIGHTS,18,16,34
15,MAY,2012,INTERNATIONAL FLIGHTS,21,23,44
16,MAY,2012,INTERNATIONAL FLIGHTS,42,43,85
17,MAY,2012,INTERNATIONAL FLIGHTS,16,14,30
18,MAY,2012,INTERNATIONAL FLIGHTS,21,20,41
19,MAY,2012,INTERNATIONAL FLIGHTS,33,34,67
20,MAY,2012,INTERNATIONAL FLIGHTS,36,36,72
21,MAY,2012,INTERNATIONAL FLIGHTS,16,17,33
22,MAY,2012,INTERNATIONAL FLIGHTS,20,19,39
23,MAY,2012,INTERNATIONAL FLIGHTS,44,44,88
24,MAY,2012,INTERNATIONAL FLIGHTS,17,17,34
25,MAY,2012,INTERNATIONAL FLIGHTS,23,22,45
26,MAY,2012,INTERNATIONAL FLIGHTS,35,35,70
27,MAY,2012,INTERNATIONAL FLIGHTS,42,39,81
28,MAY,2012,INTERNATIONAL FLIGHTS,17,19,36
29,MAY,2012,INTERNATIONAL FLIGHTS,21,23,44
30,MAY,2012,INTERNATIONAL FLIGHTS,43,42,85
31,MAY,2012,INTERNATIONAL FLIGHTS,18,21,39
1,MAY,2012,LOCAL FLIGHTS,6,6,12
2,MAY,2012,LOCAL FLIGHTS,1,1,2
3,MAY,2012,LOCAL FLIGHTS,5,5,10
4,MAY,2012,LOCAL FLIGHTS,5,5,10
5,MAY,2012,LOCAL FLIGHTS,10,10,20
6,MAY,2012,LOCAL FLIGHTS,4,4,8
7,MAY,2012,LOCAL FLIGHTS,11,11,22
8,MAY,2012,LOCAL FLIGHTS,6,6,12
9,MAY,2012,LOCAL FLIGHTS,4,5,9
10,MAY,2012,LOCAL FLIGHTS,3,3,6
11,MAY,2012,LOCAL FLIGHTS,2,2,4
12,MAY,2012,LOCAL FLIGHTS,6,6,12
13,MAY,2012,LOCAL FLIGHTS,3,3,6
14,MAY,2012,LOCAL FLIGHTS,4,4,8
15,MAY,2012,LOCAL FLIGHTS,6,5,11
16,MAY,2012,LOCAL FLIGHTS,4,4,8
17,MAY,2012,LOCAL FLIGHTS,9,10,19
18,MAY,2012,LOCAL FLIGHTS,8,8,16
19,MAY,2012,LOCAL FLIGHTS,4,4,8
20,MAY,2012,LOCAL FLIGHTS,1,1,2
21,MAY,2012,LOCAL FLIGHTS,7,7,14
22,MAY,2012,LOCAL FLIGHTS,7,7,14
23,MAY,2012,LOCAL FLIGHTS,6,6,12
24,MAY,2012,LOCAL FLIGHTS,2,2,4
25,MAY,2012,LOCAL FLIGHTS,1,1,2
26,MAY,2012,LOCAL FLIGHTS,8,7,15
27,MAY,2012,LOCAL FLIGHTS,2,2,4
28,MAY,2012,LOCAL FLIGHTS,9,10,19
29,MAY,2012,LOCAL FLIGHTS,4,4,8
30,MAY,2012,LOCAL FLIGHTS,4,4,8
31,MAY,2012,LOCAL FLIGHTS,4,4,8
1,MAY,2012,HELICOPTER FLIGHTS,0,0,0
2,MAY,2012,HELICOPTER FLIGHTS,0,0,0
3,MAY,2012,HELICOPTER FLIGHTS,6,6,12
4,MAY,2012,HELICOPTER FLIGHTS,2,2,4
5,MAY,2012,HELICOPTER FLIGHTS,0,0,0
6,MAY,2012,HELICOPTER FLIGHTS,0,0,0
7,MAY,2012,HELICOPTER FLIGHTS,13,13,26
8,MAY,2012,HELICOPTER FLIGHTS,9,9,18
9,MAY,2012,HELICOPTER FLIGHTS,7,7,14
10,MAY,2012,HELICOPTER FLIGHTS,8,8,16
11,MAY,2012,HELICOPTER FLIGHTS,1,1,2
12,MAY,2012,HELICOPTER FLIGHTS,1,1,2
13,MAY,2012,HELICOPTER FLIGHTS,1,1,2
14,MAY,2012,HELICOPTER FLIGHTS,4,4,8
15,MAY,2012,HELICOPTER FLIGHTS,9,9,18
16,MAY,2012,HELICOPTER FLIGHTS,5,5,10
17,MAY,2012,HELICOPTER FLIGHTS,17,17,34
18,MAY,2012,HELICOPTER FLIGHTS,2,2,4
19,MAY,2012,HELICOPTER FLIGHTS,0,0,0
20,MAY,2012,HELICOPTER FLIGHTS,0,0,0
21,MAY,2012,HELICOPTER FLIGHTS,12,12,24
22,MAY,2012,HELICOPTER FLIGHTS,6,6,12
23,MAY,2012,HELICOPTER FLIGHTS,6,6,12
24,MAY,2012,HELICOPTER FLIGHTS,4,4,8
25,MAY,2012,HELICOPTER FLIGHTS,1,1,2
26,MAY,2012,HELICOPTER FLIGHTS,0,0,0
27,MAY,2012,HELICOPTER FLIGHTS,0,0,0
28,MAY,2012,HELICOPTER FLIGHTS,8,8,16
29,MAY,2012,HELICOPTER FLIGHTS,7,7,14
30,MAY,2012,HELICOPTER FLIGHTS,5,5,10
31,MAY,2012,HELICOPTER FLIGHTS,16,16,32
1,JUN,2012,INTERNATIONAL FLIGHTS,18,18,36
2,JUN,2012,INTERNATIONAL FLIGHTS,36,36,72
3,JUN,2012,INTERNATIONAL FLIGHTS,47,45,92
4,JUN,2012,INTERNATIONAL FLIGHTS,17,19,36
5,JUN,2012,INTERNATIONAL FLIGHTS,24,23,47
6,JUN,2012,INTERNATIONAL FLIGHTS,46,49,95
7,JUN,2012,INTERNATIONAL FLIGHTS,19,16,35
8,JUN,2012,INTERNATIONAL FLIGHTS,20,20,40
9,JUN,2012,INTERNATIONAL FLIGHTS,41,41,82
10,JUN,2012,INTERNATIONAL FLIGHTS,43,46,89
11,JUN,2012,INTERNATIONAL FLIGHTS,17,17,34
12,JUN,2012,INTERNATIONAL FLIGHTS,23,25,48
13,JUN,2012,INTERNATIONAL FLIGHTS,49,47,96
14,JUN,2012,INTERNATIONAL FLIGHTS,18,17,35
15,JUN,2012,INTERNATIONAL FLIGHTS,19,21,40
16,JUN,2012,INTERNATIONAL FLIGHTS,35,35,70
17,JUN,2012,INTERNATIONAL FLIGHTS,45,43,88
18,JUN,2012,INTERNATIONAL FLIGHTS,20,19,39
19,JUN,2012,INTERNATIONAL FLIGHTS,24,25,49
20,JUN,2012,INTERNATIONAL FLIGHTS,50,50,100
21,JUN,2012,INTERNATIONAL FLIGHTS,16,18,34
22,JUN,2012,INTERNATIONAL FLIGHTS,20,21,41
23,JUN,2012,INTERNATIONAL FLIGHTS,34,34,68
24,JUN,2012,INTERNATIONAL FLIGHTS,41,40,81
25,JUN,2012,INTERNATIONAL FLIGHTS,17,17,34
26,JUN,2012,INTERNATIONAL FLIGHTS,30,29,59
27,JUN,2012,INTERNATIONAL FLIGHTS,47,49,96
28,JUN,2012,INTERNATIONAL FLIGHTS,18,19,37
29,JUN,2012,INTERNATIONAL FLIGHTS,21,20,41
30,JUN,2012,INTERNATIONAL FLIGHTS,32,33,65
1,JUN,2012,LOCAL FLIGHTS,1,1,2
2,JUN,2012,LOCAL FLIGHTS,7,7,14
3,JUN,2012,LOCAL FLIGHTS,1,1,2
4,JUN,2012,LOCAL FLIGHTS,2,2,4
5,JUN,2012,LOCAL FLIGHTS,4,4,8
6,JUN,2012,LOCAL FLIGHTS,4,4,8
7,JUN,2012,LOCAL FLIGHTS,7,7,14
8,JUN,2012,LOCAL FLIGHTS,5,5,10
9,JUN,2012,LOCAL FLIGHTS,6,6,12
10,JUN,2012,LOCAL FLIGHTS,1,1,2
11,JUN,2012,LOCAL FLIGHTS,3,1,4
12,JUN,2012,LOCAL FLIGHTS,2,2,4
13,JUN,2012,LOCAL FLIGHTS,2,2,4
14,JUN,2012,LOCAL FLIGHTS,4,4,8
15,JUN,2012,LOCAL FLIGHTS,4,4,8
16,JUN,2012,LOCAL FLIGHTS,8,8,16
17,JUN,2012,LOCAL FLIGHTS,2,2,4
18,JUN,2012,LOCAL FLIGHTS,22,23,45
19,JUN,2012,LOCAL FLIGHTS,5,4,9
20,JUN,2012,LOCAL FLIGHTS,2,2,4
21,JUN,2012,LOCAL FLIGHTS,1,1,2
22,JUN,2012,LOCAL FLIGHTS,1,1,2
23,JUN,2012,LOCAL FLIGHTS,2,2,4
24,JUN,2012,LOCAL FLIGHTS,3,3,6
25,JUN,2012,LOCAL FLIGHTS,5,5,10
26,JUN,2012,LOCAL FLIGHTS,7,7,14
27,JUN,2012,LOCAL FLIGHTS,4,4,8
28,JUN,2012,LOCAL FLIGHTS,5,5,10
29,JUN,2012,LOCAL FLIGHTS,3,2,5
30,JUN,2012,LOCAL FLIGHTS,4,4,8
1,JUN,2012,HELICOPTER FLIGHTS,0,0,0
2,JUN,2012,HELICOPTER FLIGHTS,0,0,0
3,JUN,2012,HELICOPTER FLIGHTS,0,0,0
4,JUN,2012,HELICOPTER FLIGHTS,0,0,0
5,JUN,2012,HELICOPTER FLIGHTS,5,5,10
6,JUN,2012,HELICOPTER FLIGHTS,10,10,20
7,JUN,2012,HELICOPTER FLIGHTS,9,9,18
8,JUN,2012,HELICOPTER FLIGHTS,1,1,2
9,JUN,2012,HELICOPTER FLIGHTS,0,0,0
10,JUN,2012,HELICOPTER FLIGHTS,0,0,0
11,JUN,2012,HELICOPTER FLIGHTS,13,13,26
12,JUN,2012,HELICOPTER FLIGHTS,6,6,12
13,JUN,2012,HELICOPTER FLIGHTS,7,7,14
14,JUN,2012,HELICOPTER FLIGHTS,7,7,14
15,JUN,2012,HELICOPTER FLIGHTS,3,3,6
16,JUN,2012,HELICOPTER FLIGHTS,2,0,2
17,JUN,2012,HELICOPTER FLIGHTS,0,0,0
18,JUN,2012,HELICOPTER FLIGHTS,12,12,24
19,JUN,2012,HELICOPTER FLIGHTS,6,6,12
20,JUN,2012,HELICOPTER FLIGHTS,4,4,8
21,JUN,2012,HELICOPTER FLIGHTS,7,7,14
22,JUN,2012,HELICOPTER FLIGHTS,5,5,10
23,JUN,2012,HELICOPTER FLIGHTS,6,6,12
24,JUN,2012,HELICOPTER FLIGHTS,0,0,0
25,JUN,2012,HELICOPTER FLIGHTS,10,10,20
26,JUN,2012,HELICOPTER FLIGHTS,6,6,12
27,JUN,2012,HELICOPTER FLIGHTS,11,11,22
28,JUN,2012,HELICOPTER FLIGHTS,6,6,12
29,JUN,2012,HELICOPTER FLIGHTS,0,0,0
30,JUN,2012,HELICOPTER FLIGHTS,0,0,0
1,JUL,2012,INTERNATIONAL FLIGHTS,42,42,84
2,JUL,2012,INTERNATIONAL FLIGHTS,25,23,48
3,JUL,2012,INTERNATIONAL FLIGHTS,21,23,44
4,JUL,2012,INTERNATIONAL FLIGHTS,46,47,93
5,JUL,2012,INTERNATIONAL FLIGHTS,17,18,35
6,JUL,2012,INTERNATIONAL FLIGHTS,20,22,42
7,JUL,2012,INTERNATIONAL FLIGHTS,34,35,69
8,JUL,2012,INTERNATIONAL FLIGHTS,42,40,82
9,JUL,2012,INTERNATIONAL FLIGHTS,19,19,38
10,JUL,2012,INTERNATIONAL FLIGHTS,21,22,43
11,JUL,2012,INTERNATIONAL FLIGHTS,47,47,94
12,JUL,2012,INTERNATIONAL FLIGHTS,18,20,38
13,JUL,2012,INTERNATIONAL FLIGHTS,22,24,46
14,JUL,2012,INTERNATIONAL FLIGHTS,33,30,63
15,JUL,2012,INTERNATIONAL FLIGHTS,43,45,88
16,JUL,2012,INTERNATIONAL FLIGHTS,21,20,41
17,JUL,2012,INTERNATIONAL FLIGHTS,24,25,49
18,JUL,2012,INTERNATIONAL FLIGHTS,49,49,98
19,JUL,2012,INTERNATIONAL FLIGHTS,18,19,37
20,JUL,2012,INTERNATIONAL FLIGHTS,20,20,40
21,JUL,2012,INTERNATIONAL FLIGHTS,39,33,72
22,JUL,2012,INTERNATIONAL FLIGHTS,41,42,83
23,JUL,2012,INTERNATIONAL FLIGHTS,18,19,37
24,JUL,2012,INTERNATIONAL FLIGHTS,22,20,42
25,JUL,2012,INTERNATIONAL FLIGHTS,48,46,94
26,JUL,2012,INTERNATIONAL FLIGHTS,18,20,38
27,JUL,2012,INTERNATIONAL FLIGHTS,19,20,39
28,JUL,2012,INTERNATIONAL FLIGHTS,33,33,66
29,JUL,2012,INTERNATIONAL FLIGHTS,43,41,84
30,JUL,2012,INTERNATIONAL FLIGHTS,19,18,37
31,JUL,2012,INTERNATIONAL FLIGHTS,19,21,40
1,JUL,2012,LOCAL FLIGHTS,2,2,4
2,JUL,2012,LOCAL FLIGHTS,3,3,6
3,JUL,2012,LOCAL FLIGHTS,17,17,34
4,JUL,2012,LOCAL FLIGHTS,2,2,4
5,JUL,2012,LOCAL FLIGHTS,2,2,4
6,JUL,2012,LOCAL FLIGHTS,5,5,10
7,JUL,2012,LOCAL FLIGHTS,7,7,14
8,JUL,2012,LOCAL FLIGHTS,2,2,4
9,JUL,2012,LOCAL FLIGHTS,7,7,14
10,JUL,2012,LOCAL FLIGHTS,4,4,8
11,JUL,2012,LOCAL FLIGHTS,4,4,8
12,JUL,2012,LOCAL FLIGHTS,6,6,12
13,JUL,2012,LOCAL FLIGHTS,7,8,15
14,JUL,2012,LOCAL FLIGHTS,1,1,2
15,JUL,2012,LOCAL FLIGHTS,1,1,2
16,JUL,2012,LOCAL FLIGHTS,3,3,6
17,JUL,2012,LOCAL FLIGHTS,2,2,4
18,JUL,2012,LOCAL FLIGHTS,1,2,3
19,JUL,2012,LOCAL FLIGHTS,3,3,6
20,JUL,2012,LOCAL FLIGHTS,0,0,0
21,JUL,2012,LOCAL FLIGHTS,1,1,2
22,JUL,2012,LOCAL FLIGHTS,2,2,4
23,JUL,2012,LOCAL FLIGHTS,5,5,10
24,JUL,2012,LOCAL FLIGHTS,3,3,6
25,JUL,2012,LOCAL FLIGHTS,4,4,8
26,JUL,2012,LOCAL FLIGHTS,2,3,5
27,JUL,2012,LOCAL FLIGHTS,2,2,4
28,JUL,2012,LOCAL FLIGHTS,3,3,6
29,JUL,2012,LOCAL FLIGHTS,2,2,4
30,JUL,2012,LOCAL FLIGHTS,5,5,10
31,JUL,2012,LOCAL FLIGHTS,5,5,10
1,JUL,2012,HELICOPTER FLIGHTS,2,2,4
2,JUL,2012,HELICOPTER FLIGHTS,2,2,4
3,JUL,2012,HELICOPTER FLIGHTS,10,10,20
4,JUL,2012,HELICOPTER FLIGHTS,8,8,16
5,JUL,2012,HELICOPTER FLIGHTS,4,4,8
6,JUL,2012,HELICOPTER FLIGHTS,0,0,0
7,JUL,2012,HELICOPTER FLIGHTS,0,0,0
8,JUL,2012,HELICOPTER FLIGHTS,0,0,0
9,JUL,2012,HELICOPTER FLIGHTS,9,9,18
10,JUL,2012,HELICOPTER FLIGHTS,6,6,12
11,JUL,2012,HELICOPTER FLIGHTS,5,5,10
12,JUL,2012,HELICOPTER FLIGHTS,7,7,14
13,JUL,2012,HELICOPTER FLIGHTS,2,2,4
14,JUL,2012,HELICOPTER FLIGHTS,0,0,0
15,JUL,2012,HELICOPTER FLIGHTS,3,3,6
16,JUL,2012,HELICOPTER FLIGHTS,5,5,10
17,JUL,2012,HELICOPTER FLIGHTS,3,3,6
18,JUL,2012,HELICOPTER FLIGHTS,6,6,12
19,JUL,2012,HELICOPTER FLIGHTS,8,8,16
20,JUL,2012,HELICOPTER FLIGHTS,0,0,0
21,JUL,2012,HELICOPTER FLIGHTS,0,0,0
22,JUL,2012,HELICOPTER FLIGHTS,2,2,4
23,JUL,2012,HELICOPTER FLIGHTS,8,8,16
24,JUL,2012,HELICOPTER FLIGHTS,7,7,14
25,JUL,2012,HELICOPTER FLIGHTS,5,5,10
26,JUL,2012,HELICOPTER FLIGHTS,0,0,0
27,JUL,2012,HELICOPTER FLIGHTS,3,3,6
28,JUL,2012,HELICOPTER FLIGHTS,0,0,0
29,JUL,2012,HELICOPTER FLIGHTS,0,0,0
30,JUL,2012,HELICOPTER FLIGHTS,6,6,12
31,JUL,2012,HELICOPTER FLIGHTS,4,4,8
1,AUG,2012,INTERNATIONAL FLIGHTS,49,48,97
2,AUG,2012,INTERNATIONAL FLIGHTS,22,46,68
3,AUG,2012,INTERNATIONAL FLIGHTS,22,23,45
4,AUG,2012,INTERNATIONAL FLIGHTS,35,33,68
5,AUG,2012,INTERNATIONAL FLIGHTS,45,43,88
6,AUG,2012,INTERNATIONAL FLIGHTS,20,23,43
7,AUG,2012,INTERNATIONAL FLIGHTS,13,13,26
8,AUG,2012,INTERNATIONAL FLIGHTS,49,47,96
9,AUG,2012,INTERNATIONAL FLIGHTS,19,20,39
10,AUG,2012,INTERNATIONAL FLIGHTS,21,21,42
11,AUG,2012,INTERNATIONAL FLIGHTS,37,35,72
12,AUG,2012,INTERNATIONAL FLIGHTS,46,44,90
13,AUG,2012,INTERNATIONAL FLIGHTS,19,21,40
14,AUG,2012,INTERNATIONAL FLIGHTS,22,23,45
15,AUG,2012,INTERNATIONAL FLIGHTS,48,46,94
16,AUG,2012,INTERNATIONAL FLIGHTS,18,18,36
17,AUG,2012,INTERNATIONAL FLIGHTS,22,22,44
18,AUG,2012,INTERNATIONAL FLIGHTS,35,35,70
19,AUG,2012,INTERNATIONAL FLIGHTS,42,42,84
20,AUG,2012,INTERNATIONAL FLIGHTS,20,21,41
21,AUG,2012,INTERNATIONAL FLIGHTS,20,22,42
22,AUG,2012,INTERNATIONAL FLIGHTS,49,49,98
23,AUG,2012,INTERNATIONAL FLIGHTS,19,19,38
24,AUG,2012,INTERNATIONAL FLIGHTS,22,23,45
25,AUG,2012,INTERNATIONAL FLIGHTS,36,33,69
26,AUG,2012,INTERNATIONAL FLIGHTS,44,43,87
27,AUG,2012,INTERNATIONAL FLIGHTS,21,21,42
28,AUG,2012,INTERNATIONAL FLIGHTS,21,20,41
29,AUG,2012,INTERNATIONAL FLIGHTS,50,52,102
30,AUG,2012,INTERNATIONAL FLIGHTS,22,17,39
31,AUG,2012,INTERNATIONAL FLIGHTS,16,20,36
1,AUG,2012,LOCAL FLIGHTS,1,1,2
2,AUG,2012,LOCAL FLIGHTS,4,4,8
3,AUG,2012,LOCAL FLIGHTS,4,4,8
4,AUG,2012,LOCAL FLIGHTS,6,6,12
5,AUG,2012,LOCAL FLIGHTS,0,0,0
6,AUG,2012,LOCAL FLIGHTS,6,6,12
7,AUG,2012,LOCAL FLIGHTS,23,22,45
8,AUG,2012,LOCAL FLIGHTS,5,5,10
9,AUG,2012,LOCAL FLIGHTS,4,4,8
10,AUG,2012,LOCAL FLIGHTS,4,4,8
11,AUG,2012,LOCAL FLIGHTS,4,4,8
12,AUG,2012,LOCAL FLIGHTS,0,0,0
13,AUG,2012,LOCAL FLIGHTS,6,6,12
14,AUG,2012,LOCAL FLIGHTS,4,4,8
15,AUG,2012,LOCAL FLIGHTS,0,0,0
16,AUG,2012,LOCAL FLIGHTS,4,4,8
17,AUG,2012,LOCAL FLIGHTS,3,3,6
18,AUG,2012,LOCAL FLIGHTS,5,5,10
19,AUG,2012,LOCAL FLIGHTS,0,0,0
20,AUG,2012,LOCAL FLIGHTS,2,2,4
21,AUG,2012,LOCAL FLIGHTS,4,4,8
22,AUG,2012,LOCAL FLIGHTS,0,0,0
23,AUG,2012,LOCAL FLIGHTS,3,4,7
24,AUG,2012,LOCAL FLIGHTS,4,4,8
25,AUG,2012,LOCAL FLIGHTS,2,3,5
26,AUG,2012,LOCAL FLIGHTS,0,0,0
27,AUG,2012,LOCAL FLIGHTS,3,3,6
28,AUG,2012,LOCAL FLIGHTS,2,2,4
29,AUG,2012,LOCAL FLIGHTS,1,1,2
30,AUG,2012,LOCAL FLIGHTS,0,0,0
31,AUG,2012,LOCAL FLIGHTS,5,5,10
1,AUG,2012,HELICOPTER FLIGHTS,5,2,7
2,AUG,2012,HELICOPTER FLIGHTS,5,5,10
3,AUG,2012,HELICOPTER FLIGHTS,0,0,0
4,AUG,2012,HELICOPTER FLIGHTS,0,0,0
5,AUG,2012,HELICOPTER FLIGHTS,0,0,0
6,AUG,2012,HELICOPTER FLIGHTS,0,0,0
7,AUG,2012,HELICOPTER FLIGHTS,10,10,20
8,AUG,2012,HELICOPTER FLIGHTS,6,6,12
9,AUG,2012,HELICOPTER FLIGHTS,4,4,8
10,AUG,2012,HELICOPTER FLIGHTS,6,6,12
11,AUG,2012,HELICOPTER FLIGHTS,0,0,0
12,AUG,2012,HELICOPTER FLIGHTS,2,2,4
13,AUG,2012,HELICOPTER FLIGHTS,18,18,36
14,AUG,2012,HELICOPTER FLIGHTS,6,6,12
15,AUG,2012,HELICOPTER FLIGHTS,1,1,2
16,AUG,2012,HELICOPTER FLIGHTS,4,4,8
17,AUG,2012,HELICOPTER FLIGHTS,3,3,6
18,AUG,2012,HELICOPTER FLIGHTS,2,2,4
19,AUG,2012,HELICOPTER FLIGHTS,0,0,0
20,AUG,2012,HELICOPTER FLIGHTS,5,5,10
21,AUG,2012,HELICOPTER FLIGHTS,11,11,22
22,AUG,2012,HELICOPTER FLIGHTS,6,6,12
23,AUG,2012,HELICOPTER FLIGHTS,3,3,6
24,AUG,2012,HELICOPTER FLIGHTS,0,0,0
25,AUG,2012,HELICOPTER FLIGHTS,0,0,0
26,AUG,2012,HELICOPTER FLIGHTS,2,2,4
27,AUG,2012,HELICOPTER FLIGHTS,11,11,22
28,AUG,2012,HELICOPTER FLIGHTS,6,6,12
29,AUG,2012,HELICOPTER FLIGHTS,7,7,14
30,AUG,2012,HELICOPTER FLIGHTS,6,6,12
31,AUG,2012,HELICOPTER FLIGHTS,3,3,6
1,SEP,2012,INTERNATIONAL FLIGHTS,33,31,64
2,SEP,2012,INTERNATIONAL FLIGHTS,47,44,91
3,SEP,2012,INTERNATIONAL FLIGHTS,17,22,39
4,SEP,2012,INTERNATIONAL FLIGHTS,21,23,44
5,SEP,2012,INTERNATIONAL FLIGHTS,48,48,96
6,SEP,2012,INTERNATIONAL FLIGHTS,19,16,35
7,SEP,2012,INTERNATIONAL FLIGHTS,30,24,54
8,SEP,2012,INTERNATIONAL FLIGHTS,35,43,78
9,SEP,2012,INTERNATIONAL FLIGHTS,42,42,84
10,SEP,2012,INTERNATIONAL FLIGHTS,20,20,40
11,SEP,2012,INTERNATIONAL FLIGHTS,24,23,47
12,SEP,2012,INTERNATIONAL FLIGHTS,48,47,95
13,SEP,2012,INTERNATIONAL FLIGHTS,17,16,33
14,SEP,2012,INTERNATIONAL FLIGHTS,20,23,43
15,SEP,2012,INTERNATIONAL FLIGHTS,32,35,67
16,SEP,2012,INTERNATIONAL FLIGHTS,44,42,86
17,SEP,2012,INTERNATIONAL FLIGHTS,18,16,34
18,SEP,2012,INTERNATIONAL FLIGHTS,22,25,47
19,SEP,2012,INTERNATIONAL FLIGHTS,47,49,96
20,SEP,2012,INTERNATIONAL FLIGHTS,16,17,33
21,SEP,2012,INTERNATIONAL FLIGHTS,19,21,40
22,SEP,2012,INTERNATIONAL FLIGHTS,32,31,63
23,SEP,2012,INTERNATIONAL FLIGHTS,45,45,90
24,SEP,2012,INTERNATIONAL FLIGHTS,17,19,36
25,SEP,2012,INTERNATIONAL FLIGHTS,22,22,44
26,SEP,2012,INTERNATIONAL FLIGHTS,47,44,91
27,SEP,2012,INTERNATIONAL FLIGHTS,17,16,33
28,SEP,2012,INTERNATIONAL FLIGHTS,23,22,45
29,SEP,2012,INTERNATIONAL FLIGHTS,36,36,72
30,SEP,2012,INTERNATIONAL FLIGHTS,45,44,89
1,SEP,2012,LOCAL FLIGHTS,4,4,8
2,SEP,2012,LOCAL FLIGHTS,4,4,8
3,SEP,2012,LOCAL FLIGHTS,6,7,13
4,SEP,2012,LOCAL FLIGHTS,4,4,8
5,SEP,2012,LOCAL FLIGHTS,1,1,2
6,SEP,2012,LOCAL FLIGHTS,3,3,6
7,SEP,2012,LOCAL FLIGHTS,6,6,12
8,SEP,2012,LOCAL FLIGHTS,7,7,14
9,SEP,2012,LOCAL FLIGHTS,5,5,10
10,SEP,2012,LOCAL FLIGHTS,6,6,12
11,SEP,2012,LOCAL FLIGHTS,7,7,14
12,SEP,2012,LOCAL FLIGHTS,1,2,3
13,SEP,2012,LOCAL FLIGHTS,4,4,8
14,SEP,2012,LOCAL FLIGHTS,5,5,10
15,SEP,2012,LOCAL FLIGHTS,5,4,9
16,SEP,2012,LOCAL FLIGHTS,2,2,4
17,SEP,2012,LOCAL FLIGHTS,3,3,6
18,SEP,2012,LOCAL FLIGHTS,5,5,10
19,SEP,2012,LOCAL FLIGHTS,1,1,2
20,SEP,2012,LOCAL FLIGHTS,2,2,4
21,SEP,2012,LOCAL FLIGHTS,2,2,4
22,SEP,2012,LOCAL FLIGHTS,6,6,12
23,SEP,2012,LOCAL FLIGHTS,0,0,0
24,SEP,2012,LOCAL FLIGHTS,1,1,2
25,SEP,2012,LOCAL FLIGHTS,4,4,8
26,SEP,2012,LOCAL FLIGHTS,2,2,4
27,SEP,2012,LOCAL FLIGHTS,4,4,8
28,SEP,2012,LOCAL FLIGHTS,2,2,4
29,SEP,2012,LOCAL FLIGHTS,8,8,16
30,SEP,2012,LOCAL FLIGHTS,0,0,0
1,SEP,2012,HELICOPTER FLIGHTS,0,0,0
2,SEP,2012,HELICOPTER FLIGHTS,4,4,8
3,SEP,2012,HELICOPTER FLIGHTS,9,9,18
4,SEP,2012,HELICOPTER FLIGHTS,6,6,12
5,SEP,2012,HELICOPTER FLIGHTS,8,8,16
6,SEP,2012,HELICOPTER FLIGHTS,6,6,12
7,SEP,2012,HELICOPTER FLIGHTS,0,0,0
8,SEP,2012,HELICOPTER FLIGHTS,0,0,0
9,SEP,2012,HELICOPTER FLIGHTS,0,0,0
10,SEP,2012,HELICOPTER FLIGHTS,11,11,22
11,SEP,2012,HELICOPTER FLIGHTS,6,6,12
12,SEP,2012,HELICOPTER FLIGHTS,9,9,18
13,SEP,2012,HELICOPTER FLIGHTS,7,7,14
14,SEP,2012,HELICOPTER FLIGHTS,2,2,4
15,SEP,2012,HELICOPTER FLIGHTS,0,0,0
16,SEP,2012,HELICOPTER FLIGHTS,0,0,0
17,SEP,2012,HELICOPTER FLIGHTS,10,10,20
18,SEP,2012,HELICOPTER FLIGHTS,10,10,20
19,SEP,2012,HELICOPTER FLIGHTS,4,4,8
20,SEP,2012,HELICOPTER FLIGHTS,9,9,18
21,SEP,2012,HELICOPTER FLIGHTS,0,0,0
22,SEP,2012,HELICOPTER FLIGHTS,0,0,0
23,SEP,2012,HELICOPTER FLIGHTS,0,0,0
24,SEP,2012,HELICOPTER FLIGHTS,11,11,22
25,SEP,2012,HELICOPTER FLIGHTS,6,6,12
26,SEP,2012,HELICOPTER FLIGHTS,10,10,20
27,SEP,2012,HELICOPTER FLIGHTS,4,4,8
28,SEP,2012,HELICOPTER FLIGHTS,2,2,4
29,SEP,2012,HELICOPTER FLIGHTS,1,0,1
30,SEP,2012,HELICOPTER FLIGHTS,0,0,0
1,OCT,2012,INTERNATIONAL FLIGHTS,20,21,41
2,OCT,2012,INTERNATIONAL FLIGHTS,23,21,44
3,OCT,2012,INTERNATIONAL FLIGHTS,48,51,99
4,OCT,2012,INTERNATIONAL FLIGHTS,17,17,34
5,OCT,2012,INTERNATIONAL FLIGHTS,25,23,48
6,OCT,2012,INTERNATIONAL FLIGHTS,34,35,69
7,OCT,2012,INTERNATIONAL FLIGHTS,46,43,89
8,OCT,2012,INTERNATIONAL FLIGHTS,23,23,46
9,OCT,2012,INTERNATIONAL FLIGHTS,23,21,44
10,OCT,2012,INTERNATIONAL FLIGHTS,48,46,94
11,OCT,2012,INTERNATIONAL FLIGHTS,15,16,31
12,OCT,2012,INTERNATIONAL FLIGHTS,20,20,40
13,OCT,2012,INTERNATIONAL FLIGHTS,33,35,68
14,OCT,2012,INTERNATIONAL FLIGHTS,44,44,88
15,OCT,2012,INTERNATIONAL FLIGHTS,19,20,39
16,OCT,2012,INTERNATIONAL FLIGHTS,21,24,45
17,OCT,2012,INTERNATIONAL FLIGHTS,42,41,83
18,OCT,2012,INTERNATIONAL FLIGHTS,19,16,35
19,OCT,2012,INTERNATIONAL FLIGHTS,18,19,37
20,OCT,2012,INTERNATIONAL FLIGHTS,31,31,62
21,OCT,2012,INTERNATIONAL FLIGHTS,41,45,86
22,OCT,2012,INTERNATIONAL FLIGHTS,18,17,35
23,OCT,2012,INTERNATIONAL FLIGHTS,18,20,38
24,OCT,2012,INTERNATIONAL FLIGHTS,44,44,88
25,OCT,2012,INTERNATIONAL FLIGHTS,20,16,36
26,OCT,2012,INTERNATIONAL FLIGHTS,21,21,42
27,OCT,2012,INTERNATIONAL FLIGHTS,31,31,62
28,OCT,2012,INTERNATIONAL FLIGHTS,40,44,84
29,OCT,2012,INTERNATIONAL FLIGHTS,12,13,25
30,OCT,2012,INTERNATIONAL FLIGHTS,18,17,35
31,OCT,2012,INTERNATIONAL FLIGHTS,38,34,72
1,OCT,2012,LOCAL FLIGHTS,1,1,2
2,OCT,2012,LOCAL FLIGHTS,1,1,2
3,OCT,2012,LOCAL FLIGHTS,1,1,2
4,OCT,2012,LOCAL FLIGHTS,1,1,2
5,OCT,2012,LOCAL FLIGHTS,2,2,4
6,OCT,2012,LOCAL FLIGHTS,1,1,2
7,OCT,2012,LOCAL FLIGHTS,2,2,4
8,OCT,2012,LOCAL FLIGHTS,4,4,8
9,OCT,2012,LOCAL FLIGHTS,8,7,15
10,OCT,2012,LOCAL FLIGHTS,6,6,12
11,OCT,2012,LOCAL FLIGHTS,4,4,8
12,OCT,2012,LOCAL FLIGHTS,4,4,8
13,OCT,2012,LOCAL FLIGHTS,6,6,12
14,OCT,2012,LOCAL FLIGHTS,3,3,6
15,OCT,2012,LOCAL FLIGHTS,2,2,4
16,OCT,2012,LOCAL FLIGHTS,5,5,10
17,OCT,2012,LOCAL FLIGHTS,5,5,10
18,OCT,2012,LOCAL FLIGHTS,4,4,8
19,OCT,2012,LOCAL FLIGHTS,4,5,9
20,OCT,2012,LOCAL FLIGHTS,7,7,14
21,OCT,2012,LOCAL FLIGHTS,1,1,2
22,OCT,2012,LOCAL FLIGHTS,3,3,6
23,OCT,2012,LOCAL FLIGHTS,3,3,6
24,OCT,2012,LOCAL FLIGHTS,3,3,6
25,OCT,2012,LOCAL FLIGHTS,2,2,4
26,OCT,2012,LOCAL FLIGHTS,1,1,2
27,OCT,2012,LOCAL FLIGHTS,1,1,2
28,OCT,2012,LOCAL FLIGHTS,0,0,0
29,OCT,2012,LOCAL FLIGHTS,3,3,6
30,OCT,2012,LOCAL FLIGHTS,3,3,6
31,OCT,2012,LOCAL FLIGHTS,2,2,4
1,OCT,2012,HELICOPTER FLIGHTS,5,5,10
2,OCT,2012,HELICOPTER FLIGHTS,5,5,10
3,OCT,2012,HELICOPTER FLIGHTS,7,7,14
4,OCT,2012,HELICOPTER FLIGHTS,9,9,18
5,OCT,2012,HELICOPTER FLIGHTS,6,6,12
6,OCT,2012,HELICOPTER FLIGHTS,0,0,0
7,OCT,2012,HELICOPTER FLIGHTS,0,0,0
8,OCT,2012,HELICOPTER FLIGHTS,5,5,10
9,OCT,2012,HELICOPTER FLIGHTS,6,6,12
10,OCT,2012,HELICOPTER FLIGHTS,5,5,10
11,OCT,2012,HELICOPTER FLIGHTS,10,10,20
12,OCT,2012,HELICOPTER FLIGHTS,5,5,10
13,OCT,2012,HELICOPTER FLIGHTS,0,0,0
14,OCT,2012,HELICOPTER FLIGHTS,0,0,0
15,OCT,2012,HELICOPTER FLIGHTS,13,13,26
16,OCT,2012,HELICOPTER FLIGHTS,5,5,10
17,OCT,2012,HELICOPTER FLIGHTS,6,6,12
18,OCT,2012,HELICOPTER FLIGHTS,12,12,24
19,OCT,2012,HELICOPTER FLIGHTS,8,8,16
20,OCT,2012,HELICOPTER FLIGHTS,1,1,2
21,OCT,2012,HELICOPTER FLIGHTS,0,0,0
22,OCT,2012,HELICOPTER FLIGHTS,11,11,22
23,OCT,2012,HELICOPTER FLIGHTS,9,9,18
24,OCT,2012,HELICOPTER FLIGHTS,7,7,14
25,OCT,2012,HELICOPTER FLIGHTS,5,5,10
26,OCT,2012,HELICOPTER FLIGHTS,1,1,2
27,OCT,2012,HELICOPTER FLIGHTS,0,0,0
28,OCT,2012,HELICOPTER FLIGHTS,0,0,0
29,OCT,2012,HELICOPTER FLIGHTS,13,13,26
30,OCT,2012,HELICOPTER FLIGHTS,4,4,8
31,OCT,2012,HELICOPTER FLIGHTS,8,8,16
1,NOV,2012,INTERNATIONAL FLIGHTS,12,13,25
2,NOV,2012,INTERNATIONAL FLIGHTS,12,13,25
3,NOV,2012,INTERNATIONAL FLIGHTS,28,30,58
4,NOV,2012,INTERNATIONAL FLIGHTS,28,30,58
5,NOV,2012,INTERNATIONAL FLIGHTS,15,17,32
6,NOV,2012,INTERNATIONAL FLIGHTS,12,11,23
7,NOV,2012,INTERNATIONAL FLIGHTS,27,26,53
8,NOV,2012,INTERNATIONAL FLIGHTS,6,5,11
9,NOV,2012,INTERNATIONAL FLIGHTS,9,8,17
10,NOV,2012,INTERNATIONAL FLIGHTS,15,15,30
11,NOV,2012,INTERNATIONAL FLIGHTS,18,18,36
12,NOV,2012,INTERNATIONAL FLIGHTS,9,11,20
13,NOV,2012,INTERNATIONAL FLIGHTS,7,7,14
14,NOV,2012,INTERNATIONAL FLIGHTS,24,22,46
15,NOV,2012,INTERNATIONAL FLIGHTS,7,6,13
16,NOV,2012,INTERNATIONAL FLIGHTS,5,6,11
17,NOV,2012,INTERNATIONAL FLIGHTS,13,15,28
18,NOV,2012,INTERNATIONAL FLIGHTS,13,14,27
19,NOV,2012,INTERNATIONAL FLIGHTS,9,7,16
20,NOV,2012,INTERNATIONAL FLIGHTS,7,6,13
21,NOV,2012,INTERNATIONAL FLIGHTS,23,24,47
22,NOV,2012,INTERNATIONAL FLIGHTS,9,8,17
23,NOV,2012,INTERNATIONAL FLIGHTS,7,9,16
24,NOV,2012,INTERNATIONAL FLIGHTS,14,12,26
25,NOV,2012,INTERNATIONAL FLIGHTS,14,16,30
26,NOV,2012,INTERNATIONAL FLIGHTS,8,9,17
27,NOV,2012,INTERNATIONAL FLIGHTS,5,5,10
28,NOV,2012,INTERNATIONAL FLIGHTS,18,20,38
29,NOV,2012,INTERNATIONAL FLIGHTS,10,7,17
30,NOV,2012,INTERNATIONAL FLIGHTS,9,9,18
1,NOV,2012,LOCAL FLIGHTS,1,1,2
2,NOV,2012,LOCAL FLIGHTS,1,1,2
3,NOV,2012,LOCAL FLIGHTS,5,5,10
4,NOV,2012,LOCAL FLIGHTS,5,5,10
5,NOV,2012,LOCAL FLIGHTS,4,4,8
6,NOV,2012,LOCAL FLIGHTS,5,5,10
7,NOV,2012,LOCAL FLIGHTS,3,3,6
8,NOV,2012,LOCAL FLIGHTS,5,5,10
9,NOV,2012,LOCAL FLIGHTS,1,1,2
10,NOV,2012,LOCAL FLIGHTS,1,1,2
11,NOV,2012,LOCAL FLIGHTS,0,0,0
12,NOV,2012,LOCAL FLIGHTS,1,1,2
13,NOV,2012,LOCAL FLIGHTS,3,4,7
14,NOV,2012,LOCAL FLIGHTS,2,2,4
15,NOV,2012,LOCAL FLIGHTS,4,4,8
16,NOV,2012,LOCAL FLIGHTS,2,2,4
17,NOV,2012,LOCAL FLIGHTS,7,7,14
18,NOV,2012,LOCAL FLIGHTS,2,2,4
19,NOV,2012,LOCAL FLIGHTS,1,1,2
20,NOV,2012,LOCAL FLIGHTS,4,4,8
21,NOV,2012,LOCAL FLIGHTS,2,2,4
22,NOV,2012,LOCAL FLIGHTS,3,3,6
23,NOV,2012,LOCAL FLIGHTS,2,2,4
24,NOV,2012,LOCAL FLIGHTS,2,2,4
25,NOV,2012,LOCAL FLIGHTS,2,2,4
26,NOV,2012,LOCAL FLIGHTS,0,0,0
27,NOV,2012,LOCAL FLIGHTS,5,5,10
28,NOV,2012,LOCAL FLIGHTS,2,2,4
29,NOV,2012,LOCAL FLIGHTS,5,4,9
30,NOV,2012,LOCAL FLIGHTS,3,3,6
1,NOV,2012,HELICOPTER FLIGHTS,7,7,14
2,NOV,2012,HELICOPTER FLIGHTS,1,1,2
3,NOV,2012,HELICOPTER FLIGHTS,4,4,8
4,NOV,2012,HELICOPTER FLIGHTS,4,3,7
5,NOV,2012,HELICOPTER FLIGHTS,6,6,12
6,NOV,2012,HELICOPTER FLIGHTS,7,7,14
7,NOV,2012,HELICOPTER FLIGHTS,1,1,2
8,NOV,2012,HELICOPTER FLIGHTS,1,1,2
9,NOV,2012,HELICOPTER FLIGHTS,0,0,0
10,NOV,2012,HELICOPTER FLIGHTS,0,0,0
11,NOV,2012,HELICOPTER FLIGHTS,0,0,0
12,NOV,2012,HELICOPTER FLIGHTS,1,1,2
13,NOV,2012,HELICOPTER FLIGHTS,0,2,2
14,NOV,2012,HELICOPTER FLIGHTS,10,10,20
15,NOV,2012,HELICOPTER FLIGHTS,3,3,6
16,NOV,2012,HELICOPTER FLIGHTS,0,0,0
17,NOV,2012,HELICOPTER FLIGHTS,0,0,0
18,NOV,2012,HELICOPTER FLIGHTS,0,0,0
19,NOV,2012,HELICOPTER FLIGHTS,5,5,10
20,NOV,2012,HELICOPTER FLIGHTS,6,6,12
21,NOV,2012,HELICOPTER FLIGHTS,5,5,10
22,NOV,2012,HELICOPTER FLIGHTS,0,0,0
23,NOV,2012,HELICOPTER FLIGHTS,3,3,6
24,NOV,2012,HELICOPTER FLIGHTS,0,0,0
25,NOV,2012,HELICOPTER FLIGHTS,0,0,0
26,NOV,2012,HELICOPTER FLIGHTS,8,8,16
27,NOV,2012,HELICOPTER FLIGHTS,7,7,14
28,NOV,2012,HELICOPTER FLIGHTS,8,8,16
29,NOV,2012,HELICOPTER FLIGHTS,0,0,0
30,NOV,2012,HELICOPTER FLIGHTS,0,0,0
1,DEC,2012,INTERNATIONAL FLIGHTS,10,12,22
2,DEC,2012,INTERNATIONAL FLIGHTS,18,19,37
3,DEC,2012,INTERNATIONAL FLIGHTS,4,6,10
4,DEC,2012,INTERNATIONAL FLIGHTS,4,6,10
5,DEC,2012,INTERNATIONAL FLIGHTS,17,18,35
6,DEC,2012,INTERNATIONAL FLIGHTS,16,16,32
7,DEC,2012,INTERNATIONAL FLIGHTS,5,5,10
8,DEC,2012,INTERNATIONAL FLIGHTS,12,10,22
9,DEC,2012,INTERNATIONAL FLIGHTS,9,10,19
10,DEC,2012,INTERNATIONAL FLIGHTS,6,5,11
11,DEC,2012,INTERNATIONAL FLIGHTS,4,7,11
12,DEC,2012,INTERNATIONAL FLIGHTS,15,12,27
13,DEC,2012,INTERNATIONAL FLIGHTS,6,7,13
14,DEC,2012,INTERNATIONAL FLIGHTS,8,5,13
15,DEC,2012,INTERNATIONAL FLIGHTS,12,15,27
16,DEC,2012,INTERNATIONAL FLIGHTS,9,10,19
17,DEC,2012,INTERNATIONAL FLIGHTS,9,7,16
18,DEC,2012,INTERNATIONAL FLIGHTS,6,6,12
19,DEC,2012,INTERNATIONAL FLIGHTS,13,15,28
20,DEC,2012,INTERNATIONAL FLIGHTS,4,6,10
21,DEC,2012,INTERNATIONAL FLIGHTS,6,5,11
22,DEC,2012,INTERNATIONAL FLIGHTS,13,12,25
23,DEC,2012,INTERNATIONAL FLIGHTS,9,9,18
24,DEC,2012,INTERNATIONAL FLIGHTS,4,5,9
25,DEC,2012,INTERNATIONAL FLIGHTS,1,1,2
26,DEC,2012,INTERNATIONAL FLIGHTS,11,12,23
27,DEC,2012,INTERNATIONAL FLIGHTS,8,7,15
28,DEC,2012,INTERNATIONAL FLIGHTS,6,8,14
29,DEC,2012,INTERNATIONAL FLIGHTS,12,12,24
30,DEC,2012,INTERNATIONAL FLIGHTS,10,10,20
31,DEC,2012,INTERNATIONAL FLIGHTS,4,3,7
1,DEC,2012,LOCAL FLIGHTS,6,6,12
2,DEC,2012,LOCAL FLIGHTS,1,1,2
3,DEC,2012,LOCAL FLIGHTS,2,2,4
4,DEC,2012,LOCAL FLIGHTS,2,2,4
5,DEC,2012,LOCAL FLIGHTS,2,2,4
6,DEC,2012,LOCAL FLIGHTS,3,3,6
7,DEC,2012,LOCAL FLIGHTS,4,4,8
8,DEC,2012,LOCAL FLIGHTS,5,5,10
9,DEC,2012,LOCAL FLIGHTS,2,2,4
10,DEC,2012,LOCAL FLIGHTS,2,2,4
11,DEC,2012,LOCAL FLIGHTS,4,4,8
12,DEC,2012,LOCAL FLIGHTS,2,2,4
13,DEC,2012,LOCAL FLIGHTS,5,5,10
14,DEC,2012,LOCAL FLIGHTS,5,5,10
15,DEC,2012,LOCAL FLIGHTS,9,9,18
16,DEC,2012,LOCAL FLIGHTS,2,2,4
17,DEC,2012,LOCAL FLIGHTS,0,0,0
18,DEC,2012,LOCAL FLIGHTS,1,1,2
19,DEC,2012,LOCAL FLIGHTS,3,3,6
20,DEC,2012,LOCAL FLIGHTS,1,1,2
21,DEC,2012,LOCAL FLIGHTS,2,2,4
22,DEC,2012,LOCAL FLIGHTS,2,2,4
23,DEC,2012,LOCAL FLIGHTS,1,1,2
24,DEC,2012,LOCAL FLIGHTS,1,1,2
25,DEC,2012,LOCAL FLIGHTS,1,1,2
26,DEC,2012,LOCAL FLIGHTS,1,1,2
27,DEC,2012,LOCAL FLIGHTS,4,4,8
28,DEC,2012,LOCAL FLIGHTS,2,2,4
29,DEC,2012,LOCAL FLIGHTS,8,8,16
30,DEC,2012,LOCAL FLIGHTS,4,4,8
31,DEC,2012,LOCAL FLIGHTS,1,1,2
1,DEC,2012,HELICOPTER FLIGHTS,0,0,0
2,DEC,2012,HELICOPTER FLIGHTS,0,0,0
3,DEC,2012,HELICOPTER FLIGHTS,0,0,0
4,DEC,2012,HELICOPTER FLIGHTS,0,0,0
5,DEC,2012,HELICOPTER FLIGHTS,10,10,20
6,DEC,2012,HELICOPTER FLIGHTS,4,5,9
7,DEC,2012,HELICOPTER FLIGHTS,0,0,0
8,DEC,2012,HELICOPTER FLIGHTS,0,0,0
9,DEC,2012,HELICOPTER FLIGHTS,0,0,0
10,DEC,2012,HELICOPTER FLIGHTS,0,0,0
11,DEC,2012,HELICOPTER FLIGHTS,2,2,4
12,DEC,2012,HELICOPTER FLIGHTS,5,5,10
13,DEC,2012,HELICOPTER FLIGHTS,5,5,10
14,DEC,2012,HELICOPTER FLIGHTS,2,2,4
15,DEC,2012,HELICOPTER FLIGHTS,0,0,0
16,DEC,2012,HELICOPTER FLIGHTS,0,0,0
17,DEC,2012,HELICOPTER FLIGHTS,3,2,5
18,DEC,2012,HELICOPTER FLIGHTS,2,2,4
19,DEC,2012,HELICOPTER FLIGHTS,6,6,12
20,DEC,2012,HELICOPTER FLIGHTS,0,0,0
21,DEC,2012,HELICOPTER FLIGHTS,0,0,0
22,DEC,2012,HELICOPTER FLIGHTS,0,0,0
23,DEC,2012,HELICOPTER FLIGHTS,0,0,0
24,DEC,2012,HELICOPTER FLIGHTS,0,0,0
25,DEC,2012,HELICOPTER FLIGHTS,0,0,0
26,DEC,2012,HELICOPTER FLIGHTS,0,0,0
27,DEC,2012,HELICOPTER FLIGHTS,0,0,0
28,DEC,2012,HELICOPTER FLIGHTS,1,1,2
29,DEC,2012,HELICOPTER FLIGHTS,0,0,0
30,DEC,2012,HELICOPTER FLIGHTS,0,0,0
31,DEC,2012,HELICOPTER FLIGHTS,0,0,0
