DAY,MONTH,YEAR,FLIGHT_CATEGORY,INBOUND_FLIGHTS,OUTBOUND_FLIGHTS,TOTAL_FLIGHTS
1,JAN,2012,INTERNATIONAL FLIGHTS,41,41,82
2,JAN,2012,INTERNATIONAL FLIGHTS,48,56,104
3,JAN,2012,INTERNATIONAL FLIGHTS,40,44,84
4,JAN,2012,INTERNATIONAL FLIGHTS,45,45,90
5,JAN,2012,INTERNATIONAL FLIGHTS,42,42,84
6,JAN,2012,INTERNATIONAL FLIGHTS,39,38,77
7,JAN,2012,INTERNATIONAL FLIGHTS,50,48,98
8,JAN,2012,INTERNATIONAL FLIGHTS,58,60,118
9,JAN,2012,INTERNATIONAL FLIGHTS,46,46,92
10,JAN,2012,INTERNATIONAL FLIGHTS,30,32,62
11,JAN,2012,INTERNATIONAL FLIGHTS,48,48,96
12,JAN,2012,INTERNATIONAL FLIGHTS,42,39,81
13,JAN,2012,INTERNATIONAL FLIGHTS,42,52,94
14,JAN,2012,INTERNATIONAL FLIGHTS,43,48,91
15,JAN,2012,INTERNATIONAL FLIGHTS,52,47,99
16,JAN,2012,INTERNATIONAL FLIGHTS,45,47,92
17,JAN,2012,INTERNATIONAL FLIGHTS,34,35,69
18,JAN,2012,INTERNATIONAL FLIGHTS,47,43,90
19,JAN,2012,INTERNATIONAL FLIGHTS,37,43,80
20,JAN,2012,INTERNATIONAL FLIGHTS,44,42,86
21,JAN,2012,INTERNATIONAL FLIGHTS,41,40,81
22,JAN,2012,INTERNATIONAL FLIGHTS,49,46,95
23,JAN,2012,INTERNATIONAL FLIGHTS,41,46,87
24,JAN,2012,INTERNATIONAL FLIGHTS,33,34,67
25,JAN,2012,INTERNATIONAL FLIGHTS,45,43,88
26,JAN,2012,INTERNATIONAL FLIGHTS,38,37,75
27,JAN,2012,INTERNATIONAL FLIGHTS,38,38,76
28,JAN,2012,INTERNATIONAL FLIGHTS,45,43,88
29,JAN,2012,INTERNATIONAL FLIGHTS,49,49,98
30,JAN,2012,INTERNATIONAL FLIGHTS,45,68,113
31,JAN,2012,INTERNATIONAL FLIGHTS,34,35,69
1,JAN,2012,LOCAL FLIGHTS,0,0,0
2,JAN,2012,LOCAL FLIGHTS,4,4,8
3,JAN,2012,LOCAL FLIGHTS,14,15,29
4,JAN,2012,LOCAL FLIGHTS,12,12,24
5,JAN,2012,LOCAL FLIGHTS,6,6,12
6,JAN,2012,LOCAL FLIGHTS,8,8,16
7,JAN,2012,LOCAL FLIGHTS,0,0,0
8,JAN,2012,LOCAL FLIGHTS,0,0,0
9,JAN,2012,LOCAL FLIGHTS,10,9,19
10,JAN,2012,LOCAL FLIGHTS,5,5,10
11,JAN,2012,LOCAL FLIGHTS,4,4,8
12,JAN,2012,LOCAL FLIGHTS,3,3,6
13,JAN,2012,LOCAL FLIGHTS,4,4,8
14,JAN,2012,LOCAL FLIGHTS,16,16,32
15,JAN,2012,LOCAL FLIGHTS,1,1,2
16,JAN,2012,LOCAL FLIGHTS,2,2,4
17,JAN,2012,LOCAL FLIGHTS,10,9,19
18,JAN,2012,LOCAL FLIGHTS,6,6,12
19,JAN,2012,LOCAL FLIGHTS,14,14,28
20,JAN,2012,LOCAL FLIGHTS,16,11,27
21,JAN,2012,LOCAL FLIGHTS,12,12,24
22,JAN,2012,LOCAL FLIGHTS,2,2,4
23,JAN,2012,LOCAL FLIGHTS,12,13,25
24,JAN,2012,LOCAL FLIGHTS,11,11,22
25,JAN,2012,LOCAL FLIGHTS,0,0,0
26,JAN,2012,LOCAL FLIGHTS,0,0,0
27,JAN,2012,LOCAL FLIGHTS,3,3,6
28,JAN,2012,LOCAL FLIGHTS,17,17,34
29,JAN,2012,LOCAL FLIGHTS,1,1,2
30,JAN,2012,LOCAL FLIGHTS,3,3,6
31,JAN,2012,LOCAL FLIGHTS,0,0,0
1,JAN,2012,HELICOPTER FLIGHTS,0,0,0
2,JAN,2012,HELICOPTER FLIGHTS,1,1,2
3,JAN,2012,HELICOPTER FLIGHTS,1,1,2
4,JAN,2012,HELICOPTER FLIGHTS,0,0,0
5,JAN,2012,HELICOPTER FLIGHTS,0,0,0
6,JAN,2012,HELICOPTER FLIGHTS,0,0,0
7,JAN,2012,HELICOPTER FLIGHTS,0,0,0
8,JAN,2012,HELICOPTER FLIGHTS,0,0,0
9,JAN,2012,HELICOPTER FLIGHTS,1,1,2
10,JAN,2012,HELICOPTER FLIGHTS,3,3,6
11,JAN,2012,HELICOPTER FLIGHTS,1,1,2
12,JAN,2012,HELICOPTER FLIGHTS,3,3,6
13,JAN,2012,HELICOPTER FLIGHTS,3,3,6
14,JAN,2012,HELICOPTER FLIGHTS,2,3,5
15,JAN,2012,HELICOPTER FLIGHTS,1,1,2
16,JAN,2012,HELICOPTER FLIGHTS,3,3,6
17,JAN,2012,HELICOPTER FLIGHTS,2,2,4
18,JAN,2012,HELICOPTER FLIGHTS,1,1,2
19,JAN,2012,HELICOPTER FLIGHTS,0,0,0
20,JAN,2012,HELICOPTER FLIGHTS,1,1,2
21,JAN,2012,HELICOPTER FLIGHTS,0,0,0
22,JAN,2012,HELICOPTER FLIGHTS,0,0,0
23,JAN,2012,HELICOPTER FLIGHTS,1,1,2
24,JAN,2012,HELICOPTER FLIGHTS,1,1,2
25,JAN,2012,HELICOPTER FLIGHTS,2,2,4
26,JAN,2012,HELICOPTER FLIGHTS,1,1,2
27,JAN,2012,HELICOPTER FLIGHTS,0,0,0
28,JAN,2012,HELICOPTER FLIGHTS,0,0,0
29,JAN,2012,HELICOPTER FLIGHTS,1,1,2
30,JAN,2012,HELICOPTER FLIGHTS,0,0,0
31,JAN,2012,HELICOPTER FLIGHTS,0,0,0
1,FEB,2012,INTERNATIONAL FLIGHTS,41,45,86
2,FEB,2012,INTERNATIONAL FLIGHTS,42,42,84
3,FEB,2012,INTERNATIONAL FLIGHTS,37,40,77
4,FEB,2012,INTERNATIONAL FLIGHTS,44,42,86
5,FEB,2012,INTERNATIONAL FLIGHTS,44,43,87
6,FEB,2012,INTERNATIONAL FLIGHTS,46,45,91
7,FEB,2012,INTERNATIONAL FLIGHTS,29,30,59
8,FEB,2012,INTERNATIONAL FLIGHTS,44,46,90
9,FEB,2012,INTERNATIONAL FLIGHTS,42,37,79
10,FEB,2012,INTERNATIONAL FLIGHTS,44,37,81
11,FEB,2012,INTERNATIONAL FLIGHTS,45,47,92
12,FEB,2012,INTERNATIONAL FLIGHTS,56,48,104
13,FEB,2012,INTERNATIONAL FLIGHTS,53,63,116
14,FEB,2012,INTERNATIONAL FLIGHTS,31,31,62
15,FEB,2012,INTERNATIONAL FLIGHTS,55,50,105
16,FEB,2012,INTERNATIONAL FLIGHTS,43,42,85
17,FEB,2012,INTERNATIONAL FLIGHTS,41,42,83
18,FEB,2012,INTERNATIONAL FLIGHTS,41,43,84
19,FEB,2012,INTERNATIONAL FLIGHTS,43,47,90
20,FEB,2012,INTERNATIONAL FLIGHTS,48,45,93
21,FEB,2012,INTERNATIONAL FLIGHTS,36,33,69
22,FEB,2012,INTERNATIONAL FLIGHTS,47,45,92
23,FEB,2012,INTERNATIONAL FLIGHTS,41,41,82
24,FEB,2012,INTERNATIONAL FLIGHTS,45,46,91
25,FEB,2012,INTERNATIONAL FLIGHTS,44,46,90
26,FEB,2012,INTERNATIONAL FLIGHTS,52,50,102
27,FEB,2012,INTERNATIONAL FLIGHTS,44,47,91
28,FEB,2012,INTERNATIONAL FLIGHTS,33,30,63
29,FEB,2012,INTERNATIONAL FLIGHTS,38,42,80
1,FEB,2012,LOCAL FLIGHTS,4,4,8
2,FEB,2012,LOCAL FLIGHTS,17,17,34
3,FEB,2012,LOCAL FLIGHTS,10,12,22
4,FEB,2012,LOCAL FLIGHTS,18,19,37
5,FEB,2012,LOCAL FLIGHTS,4,4,8
6,FEB,2012,LOCAL FLIGHTS,6,6,12
7,FEB,2012,LOCAL FLIGHTS,2,2,4
8,FEB,2012,LOCAL FLIGHTS,0,0,0
9,FEB,2012,LOCAL FLIGHTS,3,3,6
10,FEB,2012,LOCAL FLIGHTS,10,10,20
11,FEB,2012,LOCAL FLIGHTS,22,12,34
12,FEB,2012,LOCAL FLIGHTS,22,22,44
13,FEB,2012,LOCAL FLIGHTS,10,10,20
14,FEB,2012,LOCAL FLIGHTS,10,8,18
15,FEB,2012,LOCAL FLIGHTS,3,3,6
16,FEB,2012,LOCAL FLIGHTS,5,5,10
17,FEB,2012,LOCAL FLIGHTS,0,0,0
18,FEB,2012,LOCAL FLIGHTS,4,4,8
19,FEB,2012,LOCAL FLIGHTS,5,5,10
20,FEB,2012,LOCAL FLIGHTS,11,4,15
21,FEB,2012,LOCAL FLIGHTS,10,10,20
22,FEB,2012,LOCAL FLIGHTS,5,5,10
23,FEB,2012,LOCAL FLIGHTS,3,3,6
24,FEB,2012,LOCAL FLIGHTS,16,16,32
25,FEB,2012,LOCAL FLIGHTS,21,20,41
26,FEB,2012,LOCAL FLIGHTS,3,3,6
27,FEB,2012,LOCAL FLIGHTS,0,0,0
28,FEB,2012,LOCAL FLIGHTS,0,0,0
29,FEB,2012,LOCAL FLIGHTS,0,0,0
1,FEB,2012,HELICOPTER FLIGHTS,0,0,0
2,FEB,2012,HELICOPTER FLIGHTS,0,0,0
3,FEB,2012,HELICOPTER FLIGHTS,2,2,4
4,FEB,2012,HELICOPTER FLIGHTS,1,1,2
5,FEB,2012,HELICOPTER FLIGHTS,1,1,2
6,FEB,2012,HELICOPTER FLIGHTS,4,4,8
7,FEB,2012,HELICOPTER FLIGHTS,0,0,0
8,FEB,2012,HELICOPTER FLIGHTS,3,0,3
9,FEB,2012,HELICOPTER FLIGHTS,2,2,4
10,FEB,2012,HELICOPTER FLIGHTS,2,2,4
11,FEB,2012,HELICOPTER FLIGHTS,1,1,2
12,FEB,2012,HELICOPTER FLIGHTS,2,2,4
13,FEB,2012,HELICOPTER FLIGHTS,3,3,6
14,FEB,2012,HELICOPTER FLIGHTS,2,2,4
15,FEB,2012,HELICOPTER FLIGHTS,2,2,4
16,FEB,2012,HELICOPTER FLIGHTS,4,4,8
17,FEB,2012,HELICOPTER FLIGHTS,1,1,2
18,FEB,2012,HELICOPTER FLIGHTS,1,1,2
19,FEB,2012,HELICOPTER FLIGHTS,1,1,2
20,FEB,2012,HELICOPTER FLIGHTS,2,2,4
21,FEB,2012,HELICOPTER FLIGHTS,2,2,4
22,FEB,2012,HELICOPTER FLIGHTS,2,2,4
23,FEB,2012,HELICOPTER FLIGHTS,1,1,2
24,FEB,2012,HELICOPTER FLIGHTS,2,2,4
25,FEB,2012,HELICOPTER FLIGHTS,1,1,2
26,FEB,2012,HELICOPTER FLIGHTS,1,1,2
27,FEB,2012,HELICOPTER FLIGHTS,0,0,0
28,FEB,2012,HELICOPTER FLIGHTS,1,1,2
29,FEB,2012,HELICOPTER FLIGHTS,0,0,0
1,MAR,2012,INTERNATIONAL FLIGHTS,45,43,88
2,MAR,2012,INTERNATIONAL FLIGHTS,46,47,93
3,MAR,2012,INTERNATIONAL FLIGHTS,48,47,95
4,MAR,2012,INTERNATIONAL FLIGHTS,56,50,106
5,MAR,2012,INTERNATIONAL FLIGHTS,44,50,94
6,MAR,2012,INTERNATIONAL FLIGHTS,33,36,69
7,MAR,2012,INTERNATIONAL FLIGHTS,52,46,98
8,MAR,2012,INTERNATIONAL FLIGHTS,45,45,90
9,MAR,2012,INTERNATIONAL FLIGHTS,53,53,106
10,MAR,2012,INTERNATIONAL FLIGHTS,44,49,93
11,MAR,2012,INTERNATIONAL FLIGHTS,57,54,111
12,MAR,2012,INTERNATIONAL FLIGHTS,49,50,99
13,MAR,2012,INTERNATIONAL FLIGHTS,35,35,70
14,MAR,2012,INTERNATIONAL FLIGHTS,45,44,89
15,MAR,2012,INTERNATIONAL FLIGHTS,43,43,86
16,MAR,2012,INTERNATIONAL FLIGHTS,46,43,89
17,MAR,2012,INTERNATIONAL FLIGHTS,48,54,102
18,MAR,2012,INTERNATIONAL FLIGHTS,55,58,113
19,MAR,2012,INTERNATIONAL FLIGHTS,51,53,104
20,MAR,2012,INTERNATIONAL FLIGHTS,33,32,65
21,MAR,2012,INTERNATIONAL FLIGHTS,50,54,104
22,MAR,2012,INTERNATIONAL FLIGHTS,42,43,85
23,MAR,2012,INTERNATIONAL FLIGHTS,45,46,91
24,MAR,2012,INTERNATIONAL FLIGHTS,47,45,92
25,MAR,2012,INTERNATIONAL FLIGHTS,62,59,121
26,MAR,2012,INTERNATIONAL FLIGHTS,58,59,117
27,MAR,2012,INTERNATIONAL FLIGHTS,51,48,99
28,MAR,2012,INTERNATIONAL FLIGHTS,57,58,115
29,MAR,2012,INTERNATIONAL FLIGHTS,57,58,115
30,MAR,2012,INTERNATIONAL FLIGHTS,56,57,113
31,MAR,2012,INTERNATIONAL FLIGHTS,64,63,127
1,MAR,2012,LOCAL FLIGHTS,1,1,2
2,MAR,2012,LOCAL FLIGHTS,5,5,10
3,MAR,2012,LOCAL FLIGHTS,20,20,40
4,MAR,2012,LOCAL FLIGHTS,5,5,10
5,MAR,2012,LOCAL FLIGHTS,14,16,30
6,MAR,2012,LOCAL FLIGHTS,7,9,16
7,MAR,2012,LOCAL FLIGHTS,6,6,12
8,MAR,2012,LOCAL FLIGHTS,8,8,16
9,MAR,2012,LOCAL FLIGHTS,10,10,20
10,MAR,2012,LOCAL FLIGHTS,17,18,35
11,MAR,2012,LOCAL FLIGHTS,1,1,2
12,MAR,2012,LOCAL FLIGHTS,4,4,8
13,MAR,2012,LOCAL FLIGHTS,4,4,8
14,MAR,2012,LOCAL FLIGHTS,0,0,0
15,MAR,2012,LOCAL FLIGHTS,9,9,18
16,MAR,2012,LOCAL FLIGHTS,2,4,6
17,MAR,2012,LOCAL FLIGHTS,10,10,20
18,MAR,2012,LOCAL FLIGHTS,4,4,8
19,MAR,2012,LOCAL FLIGHTS,7,7,14
20,MAR,2012,LOCAL FLIGHTS,12,12,24
21,MAR,2012,LOCAL FLIGHTS,13,13,26
22,MAR,2012,LOCAL FLIGHTS,9,9,18
23,MAR,2012,LOCAL FLIGHTS,8,7,15
24,MAR,2012,LOCAL FLIGHTS,14,14,28
25,MAR,2012,LOCAL FLIGHTS,3,3,6
26,MAR,2012,LOCAL FLIGHTS,4,4,8
27,MAR,2012,LOCAL FLIGHTS,6,6,12
28,MAR,2012,LOCAL FLIGHTS,7,7,14
29,MAR,2012,LOCAL FLIGHTS,6,6,12
30,MAR,2012,LOCAL FLIGHTS,14,16,30
31,MAR,2012,LOCAL FLIGHTS,7,7,14
1,MAR,2012,HELICOPTER FLIGHTS,0,0,0
2,MAR,2012,HELICOPTER FLIGHTS,2,2,4
3,MAR,2012,HELICOPTER FLIGHTS,1,1,2
4,MAR,2012,HELICOPTER FLIGHTS,0,0,0
5,MAR,2012,HELICOPTER FLIGHTS,5,5,10
6,MAR,2012,HELICOPTER FLIGHTS,2,2,4
7,MAR,2012,HELICOPTER FLIGHTS,4,4,8
8,MAR,2012,HELICOPTER FLIGHTS,0,0,0
9,MAR,2012,HELICOPTER FLIGHTS,6,6,12
10,MAR,2012,HELICOPTER FLIGHTS,1,1,2
11,MAR,2012,HELICOPTER FLIGHTS,1,1,2
12,MAR,2012,HELICOPTER FLIGHTS,4,4,8
13,MAR,2012,HELICOPTER FLIGHTS,4,4,8
14,MAR,2012,HELICOPTER FLIGHTS,2,2,4
15,MAR,2012,HELICOPTER FLIGHTS,2,2,4
16,MAR,2012,HELICOPTER FLIGHTS,1,1,2
17,MAR,2012,HELICOPTER FLIGHTS,1,1,2
18,MAR,2012,HELICOPTER FLIGHTS,1,1,2
19,MAR,2012,HELICOPTER FLIGHTS,4,4,8
20,MAR,2012,HELICOPTER FLIGHTS,3,3,6
21,MAR,2012,HELICOPTER FLIGHTS,4,6,10
22,MAR,2012,HELICOPTER FLIGHTS,1,1,2
23,MAR,2012,HELICOPTER FLIGHTS,2,2,4
24,MAR,2012,HELICOPTER FLIGHTS,0,0,0
25,MAR,2012,HELICOPTER FLIGHTS,0,0,0
26,MAR,2012,HELICOPTER FLIGHTS,4,3,7
27,MAR,2012,HELICOPTER FLIGHTS,2,2,4
28,MAR,2012,HELICOPTER FLIGHTS,2,3,5
29,MAR,2012,HELICOPTER FLIGHTS,1,1,2
30,MAR,2012,HELICOPTER FLIGHTS,1,1,2
31,MAR,2012,HELICOPTER FLIGHTS,1,1,2
1,APR,2012,INTERNATIONAL FLIGHTS,65,63,128
2,APR,2012,INTERNATIONAL FLIGHTS,64,68,132
3,APR,2012,INTERNATIONAL FLIGHTS,57,58,115
4,APR,2012,INTERNATIONAL FLIGHTS,59,60,119
5,APR,2012,INTERNATIONAL FLIGHTS,75,67,142
6,APR,2012,INTERNATIONAL FLIGHTS,81,78,159
7,APR,2012,INTERNATIONAL FLIGHTS,55,59,114
8,APR,2012,INTERNATIONAL FLIGHTS,67,68,135
9,APR,2012,INTERNATIONAL FLIGHTS,70,72,142
10,APR,2012,INTERNATIONAL FLIGHTS,53,57,110
11,APR,2012,INTERNATIONAL FLIGHTS,65,64,129
12,APR,2012,INTERNATIONAL FLIGHTS,59,61,120
13,APR,2012,INTERNATIONAL FLIGHTS,71,69,140
14,APR,2012,INTERNATIONAL FLIGHTS,56,52,108
15,APR,2012,INTERNATIONAL FLIGHTS,62,59,121
16,APR,2012,INTERNATIONAL FLIGHTS,74,74,148
17,APR,2012,INTERNATIONAL FLIGHTS,53,50,103
18,APR,2012,INTERNATIONAL FLIGHTS,65,66,131
19,APR,2012,INTERNATIONAL FLIGHTS,63,63,126
20,APR,2012,INTERNATIONAL FLIGHTS,71,73,144
21,APR,2012,INTERNATIONAL FLIGHTS,56,57,113
22,APR,2012,INTERNATIONAL FLIGHTS,72,78,150
23,APR,2012,INTERNATIONAL FLIGHTS,76,78,154
24,APR,2012,INTERNATIONAL FLIGHTS,49,46,95
25,APR,2012,INTERNATIONAL FLIGHTS,66,63,129
26,APR,2012,INTERNATIONAL FLIGHTS,54,54,108
27,APR,2012,INTERNATIONAL FLIGHTS,77,75,152
28,APR,2012,INTERNATIONAL FLIGHTS,61,61,122
29,APR,2012,INTERNATIONAL FLIGHTS,73,70,143
30,APR,2012,INTERNATIONAL FLIGHTS,77,79,156
1,APR,2012,LOCAL FLIGHTS,2,2,4
2,APR,2012,LOCAL FLIGHTS,4,4,8
3,APR,2012,LOCAL FLIGHTS,7,7,14
4,APR,2012,LOCAL FLIGHTS,2,1,3
5,APR,2012,LOCAL FLIGHTS,3,3,6
6,APR,2012,LOCAL FLIGHTS,8,8,16
7,APR,2012,LOCAL FLIGHTS,11,11,22
8,APR,2012,LOCAL FLIGHTS,2,2,4
9,APR,2012,LOCAL FLIGHTS,7,7,14
10,APR,2012,LOCAL FLIGHTS,3,3,6
11,APR,2012,LOCAL FLIGHTS,2,2,4
12,APR,2012,LOCAL FLIGHTS,8,9,17
13,APR,2012,LOCAL FLIGHTS,13,12,25
14,APR,2012,LOCAL FLIGHTS,4,4,8
15,APR,2012,LOCAL FLIGHTS,0,0,0
16,APR,2012,LOCAL FLIGHTS,4,4,8
17,APR,2012,LOCAL FLIGHTS,5,5,10
18,APR,2012,LOCAL FLIGHTS,6,6,12
19,APR,2012,LOCAL FLIGHTS,5,5,10
20,APR,2012,LOCAL FLIGHTS,14,13,27
21,APR,2012,LOCAL FLIGHTS,23,22,45
22,APR,2012,LOCAL FLIGHTS,7,7,14
23,APR,2012,LOCAL FLIGHTS,14,14,28
24,APR,2012,LOCAL FLIGHTS,25,25,50
25,APR,2012,LOCAL FLIGHTS,12,12,24
26,APR,2012,LOCAL FLIGHTS,16,20,36
27,APR,2012,LOCAL FLIGHTS,17,17,34
28,APR,2012,LOCAL FLIGHTS,12,11,23
29,APR,2012,LOCAL FLIGHTS,4,4,8
30,APR,2012,LOCAL FLIGHTS,12,12,24
1,APR,2012,HELICOPTER FLIGHTS,2,0,2
2,APR,2012,HELICOPTER FLIGHTS,5,4,9
3,APR,2012,HELICOPTER FLIGHTS,3,3,6
4,APR,2012,HELICOPTER FLIGHTS,5,5,10
5,APR,2012,HELICOPTER FLIGHTS,3,3,6
6,APR,2012,HELICOPTER FLIGHTS,3,3,6
7,APR,2012,HELICOPTER FLIGHTS,2,2,4
8,APR,2012,HELICOPTER FLIGHTS,1,1,2
9,APR,2012,HELICOPTER FLIGHTS,0,0,0
10,APR,2012,HELICOPTER FLIGHTS,3,3,6
11,APR,2012,HELICOPTER FLIGHTS,4,4,8
12,APR,2012,HELICOPTER FLIGHTS,2,4,6
13,APR,2012,HELICOPTER FLIGHTS,2,2,4
14,APR,2012,HELICOPTER FLIGHTS,1,1,2
15,APR,2012,HELICOPTER FLIGHTS,0,0,0
16,APR,2012,HELICOPTER FLIGHTS,1,1,2
17,APR,2012,HELICOPTER FLIGHTS,3,3,6
18,APR,2012,HELICOPTER FLIGHTS,1,1,2
19,APR,2012,HELICOPTER FLIGHTS,2,2,4
20,APR,2012,HELICOPTER FLIGHTS,4,4,8
21,APR,2012,HELICOPTER FLIGHTS,1,1,2
22,APR,2012,HELICOPTER FLIGHTS,2,2,4
23,APR,2012,HELICOPTER FLIGHTS,3,3,6
24,APR,2012,HELICOPTER FLIGHTS,4,4,8
25,APR,2012,HELICOPTER FLIGHTS,1,1,2
26,APR,2012,HELICOPTER FLIGHTS,2,2,4
27,APR,2012,HELICOPTER FLIGHTS,1,1,2
28,APR,2012,HELICOPTER FLIGHTS,3,3,6
29,APR,2012,HELICOPTER FLIGHTS,1,1,2
30,APR,2012,HELICOPTER FLIGHTS,4,4,8
1,MAY,2012,INTERNATIONAL FLIGHTS,52,48,100
2,MAY,2012,INTERNATIONAL FLIGHTS,69,66,135
3,MAY,2012,INTERNATIONAL FLIGHTS,61,60,121
4,MAY,2012,INTERNATIONAL FLIGHTS,78,76,154
5,MAY,2012,INTERNATIONAL FLIGHTS,57,61,118
6,MAY,2012,INTERNATIONAL FLIGHTS,82,81,163
7,MAY,2012,INTERNATIONAL FLIGHTS,81,82,163
8,MAY,2012,INTERNATIONAL FLIGHTS,55,57,112
9,MAY,2012,INTERNATIONAL FLIGHTS,70,74,144
10,MAY,2012,INTERNATIONAL FLIGHTS,66,68,134
11,MAY,2012,INTERNATIONAL FLIGHTS,78,82,160
12,MAY,2012,INTERNATIONAL FLIGHTS,60,63,123
13,MAY,2012,INTERNATIONAL FLIGHTS,83,78,161
14,MAY,2012,INTERNATIONAL FLIGHTS,82,81,163
15,MAY,2012,INTERNATIONAL FLIGHTS,56,58,114
16,MAY,2012,INTERNATIONAL FLIGHTS,68,69,137
17,MAY,2012,INTERNATIONAL FLIGHTS,55,59,114
18,MAY,2012,INTERNATIONAL FLIGHTS,85,86,171
19,MAY,2012,INTERNATIONAL FLIGHTS,59,64,123
20,MAY,2012,INTERNATIONAL FLIGHTS,93,94,187
21,MAY,2012,INTERNATIONAL FLIGHTS,84,86,170
22,MAY,2012,INTERNATIONAL FLIGHTS,59,61,120
23,MAY,2012,INTERNATIONAL FLIGHTS,77,67,144
24,MAY,2012,INTERNATIONAL FLIGHTS,68,70,138
25,MAY,2012,INTERNATIONAL FLIGHTS,82,84,166
26,MAY,2012,INTERNATIONAL FLIGHTS,66,68,134
27,MAY,2012,INTERNATIONAL FLIGHTS,87,91,178
28,MAY,2012,INTERNATIONAL FLIGHTS,91,89,180
29,MAY,2012,INTERNATIONAL FLIGHTS,62,64,126
30,MAY,2012,INTERNATIONAL FLIGHTS,82,75,157
31,MAY,2012,INTERNATIONAL FLIGHTS,68,67,135
1,MAY,2012,LOCAL FLIGHTS,7,7,14
2,MAY,2012,LOCAL FLIGHTS,0,0,0
3,MAY,2012,LOCAL FLIGHTS,11,12,23
4,MAY,2012,LOCAL FLIGHTS,13,13,26
5,MAY,2012,LOCAL FLIGHTS,14,16,30
6,MAY,2012,LOCAL FLIGHTS,8,8,16
7,MAY,2012,LOCAL FLIGHTS,12,13,25
8,MAY,2012,LOCAL FLIGHTS,15,15,30
9,MAY,2012,LOCAL FLIGHTS,7,7,14
10,MAY,2012,LOCAL FLIGHTS,14,14,28
11,MAY,2012,LOCAL FLIGHTS,11,11,22
12,MAY,2012,LOCAL FLIGHTS,16,16,32
13,MAY,2012,LOCAL FLIGHTS,5,5,10
14,MAY,2012,LOCAL FLIGHTS,1,3,4
15,MAY,2012,LOCAL FLIGHTS,14,14,28
16,MAY,2012,LOCAL FLIGHTS,8,9,17
17,MAY,2012,LOCAL FLIGHTS,20,19,39
18,MAY,2012,LOCAL FLIGHTS,17,18,35
19,MAY,2012,LOCAL FLIGHTS,14,14,28
20,MAY,2012,LOCAL FLIGHTS,5,5,10
21,MAY,2012,LOCAL FLIGHTS,15,15,30
22,MAY,2012,LOCAL FLIGHTS,12,12,24
23,MAY,2012,LOCAL FLIGHTS,13,13,26
24,MAY,2012,LOCAL FLIGHTS,12,12,24
25,MAY,2012,LOCAL FLIGHTS,8,8,16
26,MAY,2012,LOCAL FLIGHTS,12,12,24
27,MAY,2012,LOCAL FLIGHTS,3,3,6
28,MAY,2012,LOCAL FLIGHTS,5,5,10
29,MAY,2012,LOCAL FLIGHTS,10,10,20
30,MAY,2012,LOCAL FLIGHTS,11,10,21
31,MAY,2012,LOCAL FLIGHTS,10,10,20
1,MAY,2012,HELICOPTER FLIGHTS,1,1,2
2,MAY,2012,HELICOPTER FLIGHTS,3,3,6
3,MAY,2012,HELICOPTER FLIGHTS,3,3,6
4,MAY,2012,HELICOPTER FLIGHTS,1,1,2
5,MAY,2012,HELICOPTER FLIGHTS,1,1,2
6,MAY,2012,HELICOPTER FLIGHTS,1,1,2
7,MAY,2012,HELICOPTER FLIGHTS,1,1,2
8,MAY,2012,HELICOPTER FLIGHTS,1,2,3
9,MAY,2012,HELICOPTER FLIGHTS,3,3,6
10,MAY,2012,HELICOPTER FLIGHTS,1,1,2
11,MAY,2012,HELICOPTER FLIGHTS,2,2,4
12,MAY,2012,HELICOPTER FLIGHTS,3,3,6
13,MAY,2012,HELICOPTER FLIGHTS,1,1,2
14,MAY,2012,HELICOPTER FLIGHTS,2,2,4
15,MAY,2012,HELICOPTER FLIGHTS,3,3,6
16,MAY,2012,HELICOPTER FLIGHTS,3,3,6
17,MAY,2012,HELICOPTER FLIGHTS,1,1,2
18,MAY,2012,HELICOPTER FLIGHTS,2,2,4
19,MAY,2012,HELICOPTER FLIGHTS,2,2,4
20,MAY,2012,HELICOPTER FLIGHTS,0,0,0
21,MAY,2012,HELICOPTER FLIGHTS,3,2,5
22,MAY,2012,HELICOPTER FLIGHTS,2,2,4
23,MAY,2012,HELICOPTER FLIGHTS,2,3,5
24,MAY,2012,HELICOPTER FLIGHTS,1,1,2
25,MAY,2012,HELICOPTER FLIGHTS,1,1,2
26,MAY,2012,HELICOPTER FLIGHTS,0,0,0
27,MAY,2012,HELICOPTER FLIGHTS,0,0,0
28,MAY,2012,HELICOPTER FLIGHTS,4,4,8
29,MAY,2012,HELICOPTER FLIGHTS,2,2,4
30,MAY,2012,HELICOPTER FLIGHTS,3,3,6
31,MAY,2012,HELICOPTER FLIGHTS,2,2,4
1,JUN,2012,INTERNATIONAL FLIGHTS,94,122,216
2,JUN,2012,INTERNATIONAL FLIGHTS,76,81,157
3,JUN,2012,INTERNATIONAL FLIGHTS,84,83,167
4,JUN,2012,INTERNATIONAL FLIGHTS,102,103,205
5,JUN,2012,INTERNATIONAL FLIGHTS,64,62,126
6,JUN,2012,INTERNATIONAL FLIGHTS,83,79,162
7,JUN,2012,INTERNATIONAL FLIGHTS,73,75,148
8,JUN,2012,INTERNATIONAL FLIGHTS,93,94,187
9,JUN,2012,INTERNATIONAL FLIGHTS,68,73,141
10,JUN,2012,INTERNATIONAL FLIGHTS,88,83,171
11,JUN,2012,INTERNATIONAL FLIGHTS,95,99,194
12,JUN,2012,INTERNATIONAL FLIGHTS,63,57,120
13,JUN,2012,INTERNATIONAL FLIGHTS,81,77,158
14,JUN,2012,INTERNATIONAL FLIGHTS,66,66,132
15,JUN,2012,INTERNATIONAL FLIGHTS,89,93,182
16,JUN,2012,INTERNATIONAL FLIGHTS,70,73,143
17,JUN,2012,INTERNATIONAL FLIGHTS,89,86,175
18,JUN,2012,INTERNATIONAL FLIGHTS,92,95,187
19,JUN,2012,INTERNATIONAL FLIGHTS,60,60,120
20,JUN,2012,INTERNATIONAL FLIGHTS,84,82,166
21,JUN,2012,INTERNATIONAL FLIGHTS,76,79,155
22,JUN,2012,INTERNATIONAL FLIGHTS,91,93,184
23,JUN,2012,INTERNATIONAL FLIGHTS,67,71,138
24,JUN,2012,INTERNATIONAL FLIGHTS,88,85,173
25,JUN,2012,INTERNATIONAL FLIGHTS,95,104,199
26,JUN,2012,INTERNATIONAL FLIGHTS,63,60,123
27,JUN,2012,INTERNATIONAL FLIGHTS,87,87,174
28,JUN,2012,INTERNATIONAL FLIGHTS,70,69,139
29,JUN,2012,INTERNATIONAL FLIGHTS,95,101,196
30,JUN,2012,INTERNATIONAL FLIGHTS,76,78,154
1,JUN,2012,LOCAL FLIGHTS,5,5,10
2,JUN,2012,LOCAL FLIGHTS,4,4,8
3,JUN,2012,LOCAL FLIGHTS,4,4,8
4,JUN,2012,LOCAL FLIGHTS,3,2,5
5,JUN,2012,LOCAL FLIGHTS,13,15,28
6,JUN,2012,LOCAL FLIGHTS,12,12,24
7,JUN,2012,LOCAL FLIGHTS,8,8,16
8,JUN,2012,LOCAL FLIGHTS,9,9,18
9,JUN,2012,LOCAL FLIGHTS,7,7,14
10,JUN,2012,LOCAL FLIGHTS,2,2,4
11,JUN,2012,LOCAL FLIGHTS,9,9,18
12,JUN,2012,LOCAL FLIGHTS,7,6,13
13,JUN,2012,LOCAL FLIGHTS,13,13,26
14,JUN,2012,LOCAL FLIGHTS,13,13,26
15,JUN,2012,LOCAL FLIGHTS,7,7,14
16,JUN,2012,LOCAL FLIGHTS,10,10,20
17,JUN,2012,LOCAL FLIGHTS,0,0,0
18,JUN,2012,LOCAL FLIGHTS,13,13,26
19,JUN,2012,LOCAL FLIGHTS,7,7,14
20,JUN,2012,LOCAL FLIGHTS,9,9,18
21,JUN,2012,LOCAL FLIGHTS,1,1,2
22,JUN,2012,LOCAL FLIGHTS,9,9,18
23,JUN,2012,LOCAL FLIGHTS,6,5,11
24,JUN,2012,LOCAL FLIGHTS,0,0,0
25,JUN,2012,LOCAL FLIGHTS,12,12,24
26,JUN,2012,LOCAL FLIGHTS,3,3,6
27,JUN,2012,LOCAL FLIGHTS,3,3,6
28,JUN,2012,LOCAL FLIGHTS,10,11,21
29,JUN,2012,LOCAL FLIGHTS,6,6,12
30,JUN,2012,LOCAL FLIGHTS,9,8,17
1,JUN,2012,HELICOPTER FLIGHTS,1,1,2
2,JUN,2012,HELICOPTER FLIGHTS,1,1,2
3,JUN,2012,HELICOPTER FLIGHTS,0,0,0
4,JUN,2012,HELICOPTER FLIGHTS,1,1,2
5,JUN,2012,HELICOPTER FLIGHTS,0,0,0
6,JUN,2012,HELICOPTER FLIGHTS,0,0,0
7,JUN,2012,HELICOPTER FLIGHTS,2,2,4
8,JUN,2012,HELICOPTER FLIGHTS,4,4,8
9,JUN,2012,HELICOPTER FLIGHTS,2,2,4
10,JUN,2012,HELICOPTER FLIGHTS,0,0,0
11,JUN,2012,HELICOPTER FLIGHTS,2,2,4
12,JUN,2012,HELICOPTER FLIGHTS,0,0,0
13,JUN,2012,HELICOPTER FLIGHTS,1,1,2
14,JUN,2012,HELICOPTER FLIGHTS,0,0,0
15,JUN,2012,HELICOPTER FLIGHTS,2,2,4
16,JUN,2012,HELICOPTER FLIGHTS,2,2,4
17,JUN,2012,HELICOPTER FLIGHTS,1,1,2
18,JUN,2012,HELICOPTER FLIGHTS,1,1,2
19,JUN,2012,HELICOPTER FLIGHTS,2,2,4
20,JUN,2012,HELICOPTER FLIGHTS,1,1,2
21,JUN,2012,HELICOPTER FLIGHTS,2,2,4
22,JUN,2012,HELICOPTER FLIGHTS,3,3,6
23,JUN,2012,HELICOPTER FLIGHTS,3,3,6
24,JUN,2012,HELICOPTER FLIGHTS,2,2,4
25,JUN,2012,HELICOPTER FLIGHTS,3,3,6
26,JUN,2012,HELICOPTER FLIGHTS,4,4,8
27,JUN,2012,HELICOPTER FLIGHTS,2,2,4
28,JUN,2012,HELICOPTER FLIGHTS,1,1,2
29,JUN,2012,HELICOPTER FLIGHTS,2,2,4
30,JUN,2012,HELICOPTER FLIGHTS,2,2,4
1,JUL,2012,INTERNATIONAL FLIGHTS,87,95,182
2,JUL,2012,INTERNATIONAL FLIGHTS,105,105,210
3,JUL,2012,INTERNATIONAL FLIGHTS,65,67,132
4,JUL,2012,INTERNATIONAL FLIGHTS,85,86,171
5,JUL,2012,INTERNATIONAL FLIGHTS,77,79,156
6,JUL,2012,INTERNATIONAL FLIGHTS,103,100,203
7,JUL,2012,INTERNATIONAL FLIGHTS,78,78,156
8,JUL,2012,INTERNATIONAL FLIGHTS,88,97,185
9,JUL,2012,INTERNATIONAL FLIGHTS,103,102,205
10,JUL,2012,INTERNATIONAL FLIGHTS,60,64,124
11,JUL,2012,INTERNATIONAL FLIGHTS,82,79,161
12,JUL,2012,INTERNATIONAL FLIGHTS,83,83,166
13,JUL,2012,INTERNATIONAL FLIGHTS,105,100,205
14,JUL,2012,INTERNATIONAL FLIGHTS,72,78,150
15,JUL,2012,INTERNATIONAL FLIGHTS,95,99,194
16,JUL,2012,INTERNATIONAL FLIGHTS,115,103,218
17,JUL,2012,INTERNATIONAL FLIGHTS,60,74,134
18,JUL,2012,INTERNATIONAL FLIGHTS,93,83,176
19,JUL,2012,INTERNATIONAL FLIGHTS,80,90,170
20,JUL,2012,INTERNATIONAL FLIGHTS,104,98,202
21,JUL,2012,INTERNATIONAL FLIGHTS,78,83,161
22,JUL,2012,INTERNATIONAL FLIGHTS,90,96,186
23,JUL,2012,INTERNATIONAL FLIGHTS,118,111,229
24,JUL,2012,INTERNATIONAL FLIGHTS,66,70,136
25,JUL,2012,INTERNATIONAL FLIGHTS,90,90,180
26,JUL,2012,INTERNATIONAL FLIGHTS,78,80,158
27,JUL,2012,INTERNATIONAL FLIGHTS,103,101,204
28,JUL,2012,INTERNATIONAL FLIGHTS,82,77,159
29,JUL,2012,INTERNATIONAL FLIGHTS,94,99,193
30,JUL,2012,INTERNATIONAL FLIGHTS,104,99,203
31,JUL,2012,INTERNATIONAL FLIGHTS,70,74,144
1,JUL,2012,LOCAL FLIGHTS,4,4,8
2,JUL,2012,LOCAL FLIGHTS,5,5,10
3,JUL,2012,LOCAL FLIGHTS,11,11,22
4,JUL,2012,LOCAL FLIGHTS,10,10,20
5,JUL,2012,LOCAL FLIGHTS,8,7,15
6,JUL,2012,LOCAL FLIGHTS,4,4,8
7,JUL,2012,LOCAL FLIGHTS,2,2,4
8,JUL,2012,LOCAL FLIGHTS,1,1,2
9,JUL,2012,LOCAL FLIGHTS,3,3,6
10,JUL,2012,LOCAL FLIGHTS,9,9,18
11,JUL,2012,LOCAL FLIGHTS,6,6,12
12,JUL,2012,LOCAL FLIGHTS,9,11,20
13,JUL,2012,LOCAL FLIGHTS,11,10,21
14,JUL,2012,LOCAL FLIGHTS,4,4,8
15,JUL,2012,LOCAL FLIGHTS,8,8,16
16,JUL,2012,LOCAL FLIGHTS,4,4,8
17,JUL,2012,LOCAL FLIGHTS,6,6,12
18,JUL,2012,LOCAL FLIGHTS,11,12,23
19,JUL,2012,LOCAL FLIGHTS,13,13,26
20,JUL,2012,LOCAL FLIGHTS,6,7,13
21,JUL,2012,LOCAL FLIGHTS,6,6,12
22,JUL,2012,LOCAL FLIGHTS,1,1,2
23,JUL,2012,LOCAL FLIGHTS,8,8,16
24,JUL,2012,LOCAL FLIGHTS,5,5,10
25,JUL,2012,LOCAL FLIGHTS,6,6,12
26,JUL,2012,LOCAL FLIGHTS,14,14,28
27,JUL,2012,LOCAL FLIGHTS,4,4,8
28,JUL,2012,LOCAL FLIGHTS,4,4,8
29,JUL,2012,LOCAL FLIGHTS,4,4,8
30,JUL,2012,LOCAL FLIGHTS,2,2,4
31,JUL,2012,LOCAL FLIGHTS,9,9,18
1,JUL,2012,HELICOPTER FLIGHTS,1,1,2
2,JUL,2012,HELICOPTER FLIGHTS,2,2,4
3,JUL,2012,HELICOPTER FLIGHTS,5,5,10
4,JUL,2012,HELICOPTER FLIGHTS,8,8,16
5,JUL,2012,HELICOPTER FLIGHTS,5,7,12
6,JUL,2012,HELICOPTER FLIGHTS,2,2,4
7,JUL,2012,HELICOPTER FLIGHTS,3,3,6
8,JUL,2012,HELICOPTER FLIGHTS,1,1,2
9,JUL,2012,HELICOPTER FLIGHTS,3,3,6
10,JUL,2012,HELICOPTER FLIGHTS,2,2,4
11,JUL,2012,HELICOPTER FLIGHTS,4,4,8
12,JUL,2012,HELICOPTER FLIGHTS,4,4,8
13,JUL,2012,HELICOPTER FLIGHTS,2,2,4
14,JUL,2012,HELICOPTER FLIGHTS,2,2,4
15,JUL,2012,HELICOPTER FLIGHTS,0,0,0
16,JUL,2012,HELICOPTER FLIGHTS,3,3,6
17,JUL,2012,HELICOPTER FLIGHTS,1,1,2
18,JUL,2012,HELICOPTER FLIGHTS,1,1,2
19,JUL,2012,HELICOPTER FLIGHTS,5,5,10
20,JUL,2012,HELICOPTER FLIGHTS,2,2,4
21,JUL,2012,HELICOPTER FLIGHTS,3,3,6
22,JUL,2012,HELICOPTER FLIGHTS,1,1,2
23,JUL,2012,HELICOPTER FLIGHTS,2,2,4
24,JUL,2012,HELICOPTER FLIGHTS,3,3,6
25,JUL,2012,HELICOPTER FLIGHTS,2,2,4
26,JUL,2012,HELICOPTER FLIGHTS,1,1,2
27,JUL,2012,HELICOPTER FLIGHTS,1,1,2
28,JUL,2012,HELICOPTER FLIGHTS,2,2,4
29,JUL,2012,HELICOPTER FLIGHTS,1,1,2
30,JUL,2012,HELICOPTER FLIGHTS,1,1,2
31,JUL,2012,HELICOPTER FLIGHTS,1,1,2
1,AUG,2012,INTERNATIONAL FLIGHTS,92,89,181
2,AUG,2012,INTERNATIONAL FLIGHTS,83,84,167
3,AUG,2012,INTERNATIONAL FLIGHTS,98,102,200
4,AUG,2012,INTERNATIONAL FLIGHTS,77,81,158
5,AUG,2012,INTERNATIONAL FLIGHTS,85,89,174
6,AUG,2012,INTERNATIONAL FLIGHTS,100,100,200
7,AUG,2012,INTERNATIONAL FLIGHTS,65,67,132
8,AUG,2012,INTERNATIONAL FLIGHTS,92,87,179
9,AUG,2012,INTERNATIONAL FLIGHTS,74,79,153
10,AUG,2012,INTERNATIONAL FLIGHTS,101,101,202
11,AUG,2012,INTERNATIONAL FLIGHTS,77,76,153
12,AUG,2012,INTERNATIONAL FLIGHTS,86,90,176
13,AUG,2012,INTERNATIONAL FLIGHTS,104,102,206
14,AUG,2012,INTERNATIONAL FLIGHTS,68,68,136
15,AUG,2012,INTERNATIONAL FLIGHTS,84,84,168
16,AUG,2012,INTERNATIONAL FLIGHTS,74,78,152
17,AUG,2012,INTERNATIONAL FLIGHTS,97,97,194
18,AUG,2012,INTERNATIONAL FLIGHTS,81,84,165
19,AUG,2012,INTERNATIONAL FLIGHTS,88,94,182
20,AUG,2012,INTERNATIONAL FLIGHTS,105,103,208
21,AUG,2012,INTERNATIONAL FLIGHTS,60,63,123
22,AUG,2012,INTERNATIONAL FLIGHTS,93,90,183
23,AUG,2012,INTERNATIONAL FLIGHTS,81,81,162
24,AUG,2012,INTERNATIONAL FLIGHTS,95,94,189
25,AUG,2012,INTERNATIONAL FLIGHTS,80,82,162
26,AUG,2012,INTERNATIONAL FLIGHTS,88,94,182
27,AUG,2012,INTERNATIONAL FLIGHTS,105,100,205
28,AUG,2012,INTERNATIONAL FLIGHTS,66,68,134
29,AUG,2012,INTERNATIONAL FLIGHTS,93,86,179
30,AUG,2012,INTERNATIONAL FLIGHTS,70,74,144
31,AUG,2012,INTERNATIONAL FLIGHTS,97,103,200
1,AUG,2012,LOCAL FLIGHTS,3,4,7
2,AUG,2012,LOCAL FLIGHTS,8,8,16
3,AUG,2012,LOCAL FLIGHTS,1,1,2
4,AUG,2012,LOCAL FLIGHTS,11,11,22
5,AUG,2012,LOCAL FLIGHTS,1,1,2
6,AUG,2012,LOCAL FLIGHTS,5,5,10
7,AUG,2012,LOCAL FLIGHTS,6,6,12
8,AUG,2012,LOCAL FLIGHTS,7,7,14
9,AUG,2012,LOCAL FLIGHTS,6,6,12
10,AUG,2012,LOCAL FLIGHTS,18,17,35
11,AUG,2012,LOCAL FLIGHTS,7,7,14
12,AUG,2012,LOCAL FLIGHTS,11,12,23
13,AUG,2012,LOCAL FLIGHTS,6,6,12
14,AUG,2012,LOCAL FLIGHTS,16,16,32
15,AUG,2012,LOCAL FLIGHTS,6,6,12
16,AUG,2012,LOCAL FLIGHTS,6,6,12
17,AUG,2012,LOCAL FLIGHTS,11,10,21
18,AUG,2012,LOCAL FLIGHTS,15,15,30
19,AUG,2012,LOCAL FLIGHTS,2,2,4
20,AUG,2012,LOCAL FLIGHTS,13,13,26
21,AUG,2012,LOCAL FLIGHTS,14,15,29
22,AUG,2012,LOCAL FLIGHTS,10,10,20
23,AUG,2012,LOCAL FLIGHTS,11,10,21
24,AUG,2012,LOCAL FLIGHTS,11,11,22
25,AUG,2012,LOCAL FLIGHTS,4,4,8
26,AUG,2012,LOCAL FLIGHTS,5,6,11
27,AUG,2012,LOCAL FLIGHTS,5,5,10
28,AUG,2012,LOCAL FLIGHTS,11,11,22
29,AUG,2012,LOCAL FLIGHTS,10,10,20
30,AUG,2012,LOCAL FLIGHTS,12,11,23
31,AUG,2012,LOCAL FLIGHTS,5,5,10
1,AUG,2012,HELICOPTER FLIGHTS,0,0,0
2,AUG,2012,HELICOPTER FLIGHTS,2,2,4
3,AUG,2012,HELICOPTER FLIGHTS,1,1,2
4,AUG,2012,HELICOPTER FLIGHTS,1,1,2
5,AUG,2012,HELICOPTER FLIGHTS,0,0,0
6,AUG,2012,HELICOPTER FLIGHTS,1,1,2
7,AUG,2012,HELICOPTER FLIGHTS,1,1,2
8,AUG,2012,HELICOPTER FLIGHTS,1,2,3
9,AUG,2012,HELICOPTER FLIGHTS,2,2,4
10,AUG,2012,HELICOPTER FLIGHTS,6,6,12
11,AUG,2012,HELICOPTER FLIGHTS,2,2,4
12,AUG,2012,HELICOPTER FLIGHTS,7,7,14
13,AUG,2012,HELICOPTER FLIGHTS,4,4,8
14,AUG,2012,HELICOPTER FLIGHTS,9,9,18
15,AUG,2012,HELICOPTER FLIGHTS,1,1,2
16,AUG,2012,HELICOPTER FLIGHTS,1,1,2
17,AUG,2012,HELICOPTER FLIGHTS,0,0,0
18,AUG,2012,HELICOPTER FLIGHTS,1,1,2
19,AUG,2012,HELICOPTER FLIGHTS,0,0,0
20,AUG,2012,HELICOPTER FLIGHTS,1,1,2
21,AUG,2012,HELICOPTER FLIGHTS,2,2,4
22,AUG,2012,HELICOPTER FLIGHTS,2,2,4
23,AUG,2012,HELICOPTER FLIGHTS,2,2,4
24,AUG,2012,HELICOPTER FLIGHTS,1,1,2
25,AUG,2012,HELICOPTER FLIGHTS,4,4,8
26,AUG,2012,HELICOPTER FLIGHTS,0,0,0
27,AUG,2012,HELICOPTER FLIGHTS,0,0,0
28,AUG,2012,HELICOPTER FLIGHTS,2,2,4
29,AUG,2012,HELICOPTER FLIGHTS,5,6,11
30,AUG,2012,HELICOPTER FLIGHTS,1,1,2
31,AUG,2012,HELICOPTER FLIGHTS,1,1,2
1,SEP,2012,INTERNATIONAL FLIGHTS,72,77,149
2,SEP,2012,INTERNATIONAL FLIGHTS,86,91,177
3,SEP,2012,INTERNATIONAL FLIGHTS,102,95,197
4,SEP,2012,INTERNATIONAL FLIGHTS,58,61,119
5,SEP,2012,INTERNATIONAL FLIGHTS,86,91,177
6,SEP,2012,INTERNATIONAL FLIGHTS,68,70,138
7,SEP,2012,INTERNATIONAL FLIGHTS,93,90,183
8,SEP,2012,INTERNATIONAL FLIGHTS,71,69,140
9,SEP,2012,INTERNATIONAL FLIGHTS,113,94,207
10,SEP,2012,INTERNATIONAL FLIGHTS,72,90,162
11,SEP,2012,INTERNATIONAL FLIGHTS,56,57,113
12,SEP,2012,INTERNATIONAL FLIGHTS,82,85,167
13,SEP,2012,INTERNATIONAL FLIGHTS,79,65,144
14,SEP,2012,INTERNATIONAL FLIGHTS,98,91,189
15,SEP,2012,INTERNATIONAL FLIGHTS,68,80,148
16,SEP,2012,INTERNATIONAL FLIGHTS,87,86,173
17,SEP,2012,INTERNATIONAL FLIGHTS,89,95,184
18,SEP,2012,INTERNATIONAL FLIGHTS,55,55,110
19,SEP,2012,INTERNATIONAL FLIGHTS,85,85,170
20,SEP,2012,INTERNATIONAL FLIGHTS,67,68,135
21,SEP,2012,INTERNATIONAL FLIGHTS,89,92,181
22,SEP,2012,INTERNATIONAL FLIGHTS,66,66,132
23,SEP,2012,INTERNATIONAL FLIGHTS,90,86,176
24,SEP,2012,INTERNATIONAL FLIGHTS,97,95,192
25,SEP,2012,INTERNATIONAL FLIGHTS,56,58,114
26,SEP,2012,INTERNATIONAL FLIGHTS,89,79,168
27,SEP,2012,INTERNATIONAL FLIGHTS,70,77,147
28,SEP,2012,INTERNATIONAL FLIGHTS,92,93,185
29,SEP,2012,INTERNATIONAL FLIGHTS,73,76,149
30,SEP,2012,INTERNATIONAL FLIGHTS,83,81,164
1,SEP,2012,LOCAL FLIGHTS,4,4,8
2,SEP,2012,LOCAL FLIGHTS,6,6,12
3,SEP,2012,LOCAL FLIGHTS,7,7,14
4,SEP,2012,LOCAL FLIGHTS,11,11,22
5,SEP,2012,LOCAL FLIGHTS,9,9,18
6,SEP,2012,LOCAL FLIGHTS,13,13,26
7,SEP,2012,LOCAL FLIGHTS,8,8,16
8,SEP,2012,LOCAL FLIGHTS,7,7,14
9,SEP,2012,LOCAL FLIGHTS,3,3,6
10,SEP,2012,LOCAL FLIGHTS,9,8,17
11,SEP,2012,LOCAL FLIGHTS,18,21,39
12,SEP,2012,LOCAL FLIGHTS,14,14,28
13,SEP,2012,LOCAL FLIGHTS,6,7,13
14,SEP,2012,LOCAL FLIGHTS,10,10,20
15,SEP,2012,LOCAL FLIGHTS,17,17,34
16,SEP,2012,LOCAL FLIGHTS,3,3,6
17,SEP,2012,LOCAL FLIGHTS,5,5,10
18,SEP,2012,LOCAL FLIGHTS,8,8,16
19,SEP,2012,LOCAL FLIGHTS,10,10,20
20,SEP,2012,LOCAL FLIGHTS,9,9,18
21,SEP,2012,LOCAL FLIGHTS,8,8,16
22,SEP,2012,LOCAL FLIGHTS,18,16,34
23,SEP,2012,LOCAL FLIGHTS,3,3,6
24,SEP,2012,LOCAL FLIGHTS,3,3,6
25,SEP,2012,LOCAL FLIGHTS,9,9,18
26,SEP,2012,LOCAL FLIGHTS,3,3,6
27,SEP,2012,LOCAL FLIGHTS,4,4,8
28,SEP,2012,LOCAL FLIGHTS,8,8,16
29,SEP,2012,LOCAL FLIGHTS,10,10,20
30,SEP,2012,LOCAL FLIGHTS,1,1,2
1,SEP,2012,HELICOPTER FLIGHTS,2,2,4
2,SEP,2012,HELICOPTER FLIGHTS,1,1,2
3,SEP,2012,HELICOPTER FLIGHTS,4,4,8
4,SEP,2012,HELICOPTER FLIGHTS,2,2,4
5,SEP,2012,HELICOPTER FLIGHTS,3,3,6
6,SEP,2012,HELICOPTER FLIGHTS,6,7,13
7,SEP,2012,HELICOPTER FLIGHTS,1,1,2
8,SEP,2012,HELICOPTER FLIGHTS,2,2,4
9,SEP,2012,HELICOPTER FLIGHTS,1,1,2
10,SEP,2012,HELICOPTER FLIGHTS,3,3,6
11,SEP,2012,HELICOPTER FLIGHTS,4,3,7
12,SEP,2012,HELICOPTER FLIGHTS,3,3,6
13,SEP,2012,HELICOPTER FLIGHTS,4,4,8
14,SEP,2012,HELICOPTER FLIGHTS,2,2,4
15,SEP,2012,HELICOPTER FLIGHTS,2,2,4
16,SEP,2012,HELICOPTER FLIGHTS,1,1,2
17,SEP,2012,HELICOPTER FLIGHTS,1,1,2
18,SEP,2012,HELICOPTER FLIGHTS,2,2,4
19,SEP,2012,HELICOPTER FLIGHTS,2,2,4
20,SEP,2012,HELICOPTER FLIGHTS,2,2,4
21,SEP,2012,HELICOPTER FLIGHTS,1,1,2
22,SEP,2012,HELICOPTER FLIGHTS,1,1,2
23,SEP,2012,HELICOPTER FLIGHTS,0,0,0
24,SEP,2012,HELICOPTER FLIGHTS,3,3,6
25,SEP,2012,HELICOPTER FLIGHTS,2,2,4
26,SEP,2012,HELICOPTER FLIGHTS,2,2,4
27,SEP,2012,HELICOPTER FLIGHTS,4,4,8
28,SEP,2012,HELICOPTER FLIGHTS,3,3,6
29,SEP,2012,HELICOPTER FLIGHTS,2,2,4
30,SEP,2012,HELICOPTER FLIGHTS,1,1,2
1,OCT,2012,INTERNATIONAL FLIGHTS,91,89,180
2,OCT,2012,INTERNATIONAL FLIGHTS,54,58,112
3,OCT,2012,INTERNATIONAL FLIGHTS,79,76,155
4,OCT,2012,INTERNATIONAL FLIGHTS,71,68,139
5,OCT,2012,INTERNATIONAL FLIGHTS,83,88,171
6,OCT,2012,INTERNATIONAL FLIGHTS,64,66,130
7,OCT,2012,INTERNATIONAL FLIGHTS,82,82,164
8,OCT,2012,INTERNATIONAL FLIGHTS,87,89,176
9,OCT,2012,INTERNATIONAL FLIGHTS,57,58,115
10,OCT,2012,INTERNATIONAL FLIGHTS,79,79,158
11,OCT,2012,INTERNATIONAL FLIGHTS,61,65,126
12,OCT,2012,INTERNATIONAL FLIGHTS,85,88,173
13,OCT,2012,INTERNATIONAL FLIGHTS,67,66,133
14,OCT,2012,INTERNATIONAL FLIGHTS,81,83,164
15,OCT,2012,INTERNATIONAL FLIGHTS,87,87,174
16,OCT,2012,INTERNATIONAL FLIGHTS,51,51,102
17,OCT,2012,INTERNATIONAL FLIGHTS,80,77,157
18,OCT,2012,INTERNATIONAL FLIGHTS,64,62,126
19,OCT,2012,INTERNATIONAL FLIGHTS,84,85,169
20,OCT,2012,INTERNATIONAL FLIGHTS,65,70,135
21,OCT,2012,INTERNATIONAL FLIGHTS,82,80,162
22,OCT,2012,INTERNATIONAL FLIGHTS,78,77,155
23,OCT,2012,INTERNATIONAL FLIGHTS,50,49,99
24,OCT,2012,INTERNATIONAL FLIGHTS,71,77,148
25,OCT,2012,INTERNATIONAL FLIGHTS,58,60,118
26,OCT,2012,INTERNATIONAL FLIGHTS,71,74,145
27,OCT,2012,INTERNATIONAL FLIGHTS,61,60,121
28,OCT,2012,INTERNATIONAL FLIGHTS,74,71,145
29,OCT,2012,INTERNATIONAL FLIGHTS,67,70,137
30,OCT,2012,INTERNATIONAL FLIGHTS,36,38,74
31,OCT,2012,INTERNATIONAL FLIGHTS,77,76,153
1,OCT,2012,LOCAL FLIGHTS,1,1,2
2,OCT,2012,LOCAL FLIGHTS,3,3,6
3,OCT,2012,LOCAL FLIGHTS,5,5,10
4,OCT,2012,LOCAL FLIGHTS,1,1,2
5,OCT,2012,LOCAL FLIGHTS,5,5,10
6,OCT,2012,LOCAL FLIGHTS,5,5,10
7,OCT,2012,LOCAL FLIGHTS,6,6,12
8,OCT,2012,LOCAL FLIGHTS,4,4,8
9,OCT,2012,LOCAL FLIGHTS,9,9,18
10,OCT,2012,LOCAL FLIGHTS,9,10,19
11,OCT,2012,LOCAL FLIGHTS,9,9,18
12,OCT,2012,LOCAL FLIGHTS,2,2,4
13,OCT,2012,LOCAL FLIGHTS,3,3,6
14,OCT,2012,LOCAL FLIGHTS,1,1,2
15,OCT,2012,LOCAL FLIGHTS,1,1,2
16,OCT,2012,LOCAL FLIGHTS,3,3,6
17,OCT,2012,LOCAL FLIGHTS,6,6,12
18,OCT,2012,LOCAL FLIGHTS,4,4,8
19,OCT,2012,LOCAL FLIGHTS,3,3,6
20,OCT,2012,LOCAL FLIGHTS,2,2,4
21,OCT,2012,LOCAL FLIGHTS,0,0,0
22,OCT,2012,LOCAL FLIGHTS,1,1,2
23,OCT,2012,LOCAL FLIGHTS,3,3,6
24,OCT,2012,LOCAL FLIGHTS,4,4,8
25,OCT,2012,LOCAL FLIGHTS,1,1,2
26,OCT,2012,LOCAL FLIGHTS,3,3,6
27,OCT,2012,LOCAL FLIGHTS,10,10,20
28,OCT,2012,LOCAL FLIGHTS,3,3,6
29,OCT,2012,LOCAL FLIGHTS,1,1,2
30,OCT,2012,LOCAL FLIGHTS,4,4,8
31,OCT,2012,LOCAL FLIGHTS,3,3,6
1,OCT,2012,HELICOPTER FLIGHTS,0,0,0
2,OCT,2012,HELICOPTER FLIGHTS,2,2,4
3,OCT,2012,HELICOPTER FLIGHTS,4,4,8
4,OCT,2012,HELICOPTER FLIGHTS,2,2,4
5,OCT,2012,HELICOPTER FLIGHTS,0,0,0
6,OCT,2012,HELICOPTER FLIGHTS,1,1,2
7,OCT,2012,HELICOPTER FLIGHTS,0,0,0
8,OCT,2012,HELICOPTER FLIGHTS,2,1,3
9,OCT,2012,HELICOPTER FLIGHTS,4,4,8
10,OCT,2012,HELICOPTER FLIGHTS,3,3,6
11,OCT,2012,HELICOPTER FLIGHTS,4,4,8
12,OCT,2012,HELICOPTER FLIGHTS,3,3,6
13,OCT,2012,HELICOPTER FLIGHTS,1,1,2
14,OCT,2012,HELICOPTER FLIGHTS,1,1,2
15,OCT,2012,HELICOPTER FLIGHTS,2,2,4
16,OCT,2012,HELICOPTER FLIGHTS,3,3,6
17,OCT,2012,HELICOPTER FLIGHTS,0,0,0
18,OCT,2012,HELICOPTER FLIGHTS,1,1,2
19,OCT,2012,HELICOPTER FLIGHTS,1,1,2
20,OCT,2012,HELICOPTER FLIGHTS,4,4,8
21,OCT,2012,HELICOPTER FLIGHTS,0,0,0
22,OCT,2012,HELICOPTER FLIGHTS,1,1,2
23,OCT,2012,HELICOPTER FLIGHTS,2,2,4
24,OCT,2012,HELICOPTER FLIGHTS,4,4,8
25,OCT,2012,HELICOPTER FLIGHTS,2,2,4
26,OCT,2012,HELICOPTER FLIGHTS,1,1,2
27,OCT,2012,HELICOPTER FLIGHTS,2,2,4
28,OCT,2012,HELICOPTER FLIGHTS,1,1,2
29,OCT,2012,HELICOPTER FLIGHTS,2,2,4
30,OCT,2012,HELICOPTER FLIGHTS,8,7,15
31,OCT,2012,HELICOPTER FLIGHTS,0,0,0
1,NOV,2012,INTERNATIONAL FLIGHTS,44,45,89
2,NOV,2012,INTERNATIONAL FLIGHTS,53,51,104
3,NOV,2012,INTERNATIONAL FLIGHTS,54,57,111
4,NOV,2012,INTERNATIONAL FLIGHTS,70,69,139
5,NOV,2012,INTERNATIONAL FLIGHTS,54,61,115
6,NOV,2012,INTERNATIONAL FLIGHTS,37,39,76
7,NOV,2012,INTERNATIONAL FLIGHTS,58,58,116
8,NOV,2012,INTERNATIONAL FLIGHTS,44,43,87
9,NOV,2012,INTERNATIONAL FLIGHTS,56,58,114
10,NOV,2012,INTERNATIONAL FLIGHTS,54,58,112
11,NOV,2012,INTERNATIONAL FLIGHTS,52,56,108
12,NOV,2012,INTERNATIONAL FLIGHTS,49,49,98
13,NOV,2012,INTERNATIONAL FLIGHTS,31,34,65
14,NOV,2012,INTERNATIONAL FLIGHTS,49,50,99
15,NOV,2012,INTERNATIONAL FLIGHTS,39,35,74
16,NOV,2012,INTERNATIONAL FLIGHTS,48,51,99
17,NOV,2012,INTERNATIONAL FLIGHTS,39,41,80
18,NOV,2012,INTERNATIONAL FLIGHTS,44,41,85
19,NOV,2012,INTERNATIONAL FLIGHTS,49,48,97
20,NOV,2012,INTERNATIONAL FLIGHTS,39,42,81
21,NOV,2012,INTERNATIONAL FLIGHTS,49,50,99
22,NOV,2012,INTERNATIONAL FLIGHTS,37,35,72
23,NOV,2012,INTERNATIONAL FLIGHTS,38,37,75
24,NOV,2012,INTERNATIONAL FLIGHTS,43,42,85
25,NOV,2012,INTERNATIONAL FLIGHTS,47,46,93
26,NOV,2012,INTERNATIONAL FLIGHTS,45,49,94
27,NOV,2012,INTERNATIONAL FLIGHTS,40,35,75
28,NOV,2012,INTERNATIONAL FLIGHTS,45,49,94
29,NOV,2012,INTERNATIONAL FLIGHTS,38,39,77
30,NOV,2012,INTERNATIONAL FLIGHTS,40,39,79
1,NOV,2012,LOCAL FLIGHTS,4,4,8
2,NOV,2012,LOCAL FLIGHTS,1,1,2
3,NOV,2012,LOCAL FLIGHTS,11,11,22
4,NOV,2012,LOCAL FLIGHTS,10,10,20
5,NOV,2012,LOCAL FLIGHTS,3,3,6
6,NOV,2012,LOCAL FLIGHTS,12,11,23
7,NOV,2012,LOCAL FLIGHTS,6,6,12
8,NOV,2012,LOCAL FLIGHTS,6,5,11
9,NOV,2012,LOCAL FLIGHTS,1,1,2
10,NOV,2012,LOCAL FLIGHTS,5,5,10
11,NOV,2012,LOCAL FLIGHTS,0,0,0
12,NOV,2012,LOCAL FLIGHTS,6,6,12
13,NOV,2012,LOCAL FLIGHTS,8,7,15
14,NOV,2012,LOCAL FLIGHTS,3,3,6
15,NOV,2012,LOCAL FLIGHTS,3,3,6
16,NOV,2012,LOCAL FLIGHTS,7,7,14
17,NOV,2012,LOCAL FLIGHTS,4,4,8
18,NOV,2012,LOCAL FLIGHTS,0,0,0
19,NOV,2012,LOCAL FLIGHTS,6,6,12
20,NOV,2012,LOCAL FLIGHTS,4,4,8
21,NOV,2012,LOCAL FLIGHTS,7,7,14
22,NOV,2012,LOCAL FLIGHTS,1,1,2
23,NOV,2012,LOCAL FLIGHTS,2,2,4
24,NOV,2012,LOCAL FLIGHTS,10,9,19
25,NOV,2012,LOCAL FLIGHTS,3,3,6
26,NOV,2012,LOCAL FLIGHTS,7,7,14
27,NOV,2012,LOCAL FLIGHTS,12,11,23
28,NOV,2012,LOCAL FLIGHTS,9,7,16
29,NOV,2012,LOCAL FLIGHTS,8,8,16
30,NOV,2012,LOCAL FLIGHTS,6,6,12
1,NOV,2012,HELICOPTER FLIGHTS,2,2,4
2,NOV,2012,HELICOPTER FLIGHTS,1,1,2
3,NOV,2012,HELICOPTER FLIGHTS,1,1,2
4,NOV,2012,HELICOPTER FLIGHTS,1,1,2
5,NOV,2012,HELICOPTER FLIGHTS,2,2,4
6,NOV,2012,HELICOPTER FLIGHTS,0,0,0
7,NOV,2012,HELICOPTER FLIGHTS,2,2,4
8,NOV,2012,HELICOPTER FLIGHTS,2,2,4
9,NOV,2012,HELICOPTER FLIGHTS,1,1,2
10,NOV,2012,HELICOPTER FLIGHTS,0,0,0
11,NOV,2012,HELICOPTER FLIGHTS,2,2,4
12,NOV,2012,HELICOPTER FLIGHTS,0,0,0
13,NOV,2012,HELICOPTER FLIGHTS,2,2,4
14,NOV,2012,HELICOPTER FLIGHTS,2,2,4
15,NOV,2012,HELICOPTER FLIGHTS,1,1,2
16,NOV,2012,HELICOPTER FLIGHTS,1,1,2
17,NOV,2012,HELICOPTER FLIGHTS,1,1,2
18,NOV,2012,HELICOPTER FLIGHTS,0,0,0
19,NOV,2012,HELICOPTER FLIGHTS,2,2,4
20,NOV,2012,HELICOPTER FLIGHTS,1,1,2
21,NOV,2012,HELICOPTER FLIGHTS,2,2,4
22,NOV,2012,HELICOPTER FLIGHTS,0,0,0
23,NOV,2012,HELICOPTER FLIGHTS,2,2,4
24,NOV,2012,HELICOPTER FLIGHTS,2,2,4
25,NOV,2012,HELICOPTER FLIGHTS,1,1,2
26,NOV,2012,HELICOPTER FLIGHTS,1,2,3
27,NOV,2012,HELICOPTER FLIGHTS,2,2,4
28,NOV,2012,HELICOPTER FLIGHTS,2,2,4
29,NOV,2012,HELICOPTER FLIGHTS,0,0,0
30,NOV,2012,HELICOPTER FLIGHTS,4,4,8
1,DEC,2012,INTERNATIONAL FLIGHTS,45,46,91
2,DEC,2012,INTERNATIONAL FLIGHTS,43,40,83
3,DEC,2012,INTERNATIONAL FLIGHTS,41,44,85
4,DEC,2012,INTERNATIONAL FLIGHTS,31,34,65
5,DEC,2012,INTERNATIONAL FLIGHTS,52,44,96
6,DEC,2012,INTERNATIONAL FLIGHTS,37,36,73
7,DEC,2012,INTERNATIONAL FLIGHTS,35,42,77
8,DEC,2012,INTERNATIONAL FLIGHTS,39,41,80
9,DEC,2012,INTERNATIONAL FLIGHTS,40,41,81
10,DEC,2012,INTERNATIONAL FLIGHTS,38,43,81
11,DEC,2012,INTERNATIONAL FLIGHTS,34,34,68
12,DEC,2012,INTERNATIONAL FLIGHTS,50,46,96
13,DEC,2012,INTERNATIONAL FLIGHTS,33,33,66
14,DEC,2012,INTERNATIONAL FLIGHTS,43,45,88
15,DEC,2012,INTERNATIONAL FLIGHTS,44,44,88
16,DEC,2012,INTERNATIONAL FLIGHTS,39,40,79
17,DEC,2012,INTERNATIONAL FLIGHTS,42,41,83
18,DEC,2012,INTERNATIONAL FLIGHTS,35,31,66
19,DEC,2012,INTERNATIONAL FLIGHTS,53,50,103
20,DEC,2012,INTERNATIONAL FLIGHTS,39,35,74
21,DEC,2012,INTERNATIONAL FLIGHTS,45,50,95
22,DEC,2012,INTERNATIONAL FLIGHTS,49,51,100
23,DEC,2012,INTERNATIONAL FLIGHTS,42,43,85
24,DEC,2012,INTERNATIONAL FLIGHTS,37,38,75
25,DEC,2012,INTERNATIONAL FLIGHTS,19,28,47
26,DEC,2012,INTERNATIONAL FLIGHTS,41,42,83
27,DEC,2012,INTERNATIONAL FLIGHTS,33,31,64
28,DEC,2012,INTERNATIONAL FLIGHTS,41,40,81
29,DEC,2012,INTERNATIONAL FLIGHTS,42,45,87
30,DEC,2012,INTERNATIONAL FLIGHTS,43,42,85
31,DEC,2012,INTERNATIONAL FLIGHTS,33,33,66
1,DEC,2012,LOCAL FLIGHTS,7,7,14
2,DEC,2012,LOCAL FLIGHTS,0,0,0
3,DEC,2012,LOCAL FLIGHTS,1,1,2
4,DEC,2012,LOCAL FLIGHTS,0,0,0
5,DEC,2012,LOCAL FLIGHTS,0,0,0
6,DEC,2012,LOCAL FLIGHTS,33,33,66
7,DEC,2012,LOCAL FLIGHTS,2,2,4
8,DEC,2012,LOCAL FLIGHTS,5,5,10
9,DEC,2012,LOCAL FLIGHTS,2,2,4
10,DEC,2012,LOCAL FLIGHTS,1,0,1
11,DEC,2012,LOCAL FLIGHTS,5,5,10
12,DEC,2012,LOCAL FLIGHTS,5,5,10
13,DEC,2012,LOCAL FLIGHTS,1,1,2
14,DEC,2012,LOCAL FLIGHTS,5,5,10
15,DEC,2012,LOCAL FLIGHTS,16,16,32
16,DEC,2012,LOCAL FLIGHTS,1,1,2
17,DEC,2012,LOCAL FLIGHTS,4,4,8
18,DEC,2012,LOCAL FLIGHTS,0,0,0
19,DEC,2012,LOCAL FLIGHTS,1,2,3
20,DEC,2012,LOCAL FLIGHTS,1,1,2
21,DEC,2012,LOCAL FLIGHTS,2,2,4
22,DEC,2012,LOCAL FLIGHTS,4,4,8
23,DEC,2012,LOCAL FLIGHTS,0,0,0
24,DEC,2012,LOCAL FLIGHTS,0,0,0
25,DEC,2012,LOCAL FLIGHTS,0,0,0
26,DEC,2012,LOCAL FLIGHTS,6,6,12
27,DEC,2012,LOCAL FLIGHTS,5,5,10
28,DEC,2012,LOCAL FLIGHTS,6,6,12
29,DEC,2012,LOCAL FLIGHTS,4,4,8
30,DEC,2012,LOCAL FLIGHTS,1,1,2
31,DEC,2012,LOCAL FLIGHTS,3,3,6
1,DEC,2012,HELICOPTER FLIGHTS,2,2,4
2,DEC,2012,HELICOPTER FLIGHTS,0,0,0
3,DEC,2012,HELICOPTER FLIGHTS,2,2,4
4,DEC,2012,HELICOPTER FLIGHTS,2,2,4
5,DEC,2012,HELICOPTER FLIGHTS,2,2,4
6,DEC,2012,HELICOPTER FLIGHTS,0,0,0
7,DEC,2012,HELICOPTER FLIGHTS,2,2,4
8,DEC,2012,HELICOPTER FLIGHTS,2,2,4
9,DEC,2012,HELICOPTER FLIGHTS,2,2,4
10,DEC,2012,HELICOPTER FLIGHTS,2,2,4
11,DEC,2012,HELICOPTER FLIGHTS,2,2,4
12,DEC,2012,HELICOPTER FLIGHTS,4,4,8
13,DEC,2012,HELICOPTER FLIGHTS,2,2,4
14,DEC,2012,HELICOPTER FLIGHTS,3,3,6
15,DEC,2012,HELICOPTER FLIGHTS,2,2,4
16,DEC,2012,HELICOPTER FLIGHTS,1,1,2
17,DEC,2012,HELICOPTER FLIGHTS,1,1,2
18,DEC,2012,HELICOPTER FLIGHTS,1,1,2
19,DEC,2012,HELICOPTER FLIGHTS,1,1,2
20,DEC,2012,HELICOPTER FLIGHTS,0,0,0
21,DEC,2012,HELICOPTER FLIGHTS,1,1,2
22,DEC,2012,HELICOPTER FLIGHTS,1,1,2
23,DEC,2012,HELICOPTER FLIGHTS,1,1,2
24,DEC,2012,HELICOPTER FLIGHTS,0,0,0
25,DEC,2012,HELICOPTER FLIGHTS,0,0,0
26,DEC,2012,HELICOPTER FLIGHTS,0,0,0
27,DEC,2012,HELICOPTER FLIGHTS,2,2,4
28,DEC,2012,HELICOPTER FLIGHTS,2,3,5
29,DEC,2012,HELICOPTER FLIGHTS,2,2,4
30,DEC,2012,HELICOPTER FLIGHTS,1,1,2
31,DEC,2012,HELICOPTER FLIGHTS,0,0,0
