DAY,MONTH,YEAR,FLIGHT_CATEGORY,INBOUND_FLIGHTS,OUTBOUND_FLIGHTS,TOTAL_FLIGHTS
1,JAN,2013,INTERNATIONAL FLIGHTS,20,21,41
2,JAN,2013,INTERNATIONAL FLIGHTS,43,43,86
3,JAN,2013,INTERNATIONAL FLIGHTS,33,33,66
4,JAN,2013,INTERNATIONAL FLIGHTS,42,44,86
5,JAN,2013,INTERNATIONAL FLIGHTS,44,44,88
6,JAN,2013,INTERNATIONAL FLIGHTS,42,41,83
7,JAN,2013,INTERNATIONAL FLIGHTS,37,39,76
8,JAN,2013,INTERNATIONAL FLIGHTS,31,31,62
9,JAN,2013,INTERNATIONAL FLIGHTS,41,43,84
10,JAN,2013,INTERNATIONAL FLIGHTS,29,33,62
11,JAN,2013,INTERNATIONAL FLIGHTS,40,38,78
12,JAN,2013,INTERNATIONAL FLIGHTS,46,42,88
13,JAN,2013,INTERNATIONAL FLIGHTS,39,42,81
14,JAN,2013,INTERNATIONAL FLIGHTS,37,37,74
15,JAN,2013,INTERNATIONAL FLIGHTS,25,26,51
16,JAN,2013,INTERNATIONAL FLIGHTS,41,42,83
17,JAN,2013,INTERNATIONAL FLIGHTS,22,28,50
18,JAN,2013,INTERNATIONAL FLIGHTS,37,39,76
19,JAN,2013,INTERNATIONAL FLIGHTS,34,36,70
20,JAN,2013,INTERNATIONAL FLIGHTS,34,32,66
21,JAN,2013,INTERNATIONAL FLIGHTS,40,39,79
22,JAN,2013,INTERNATIONAL FLIGHTS,26,24,50
23,JAN,2013,INTERNATIONAL FLIGHTS,45,43,88
24,JAN,2013,INTERNATIONAL FLIGHTS,30,31,61
25,JAN,2013,INTERNATIONAL FLIGHTS,36,36,72
26,JAN,2013,INTERNATIONAL FLIGHTS,37,38,75
27,JAN,2013,INTERNATIONAL FLIGHTS,33,35,68
28,JAN,2013,INTERNATIONAL FLIGHTS,37,36,73
29,JAN,2013,INTERNATIONAL FLIGHTS,27,21,48
30,JAN,2013,INTERNATIONAL FLIGHTS,37,39,76
31,JAN,2013,INTERNATIONAL FLIGHTS,29,30,59
1,JAN,2013,LOCAL FLIGHTS,0,0,0
2,JAN,2013,LOCAL FLIGHTS,2,2,4
3,JAN,2013,LOCAL FLIGHTS,8,8,16
4,JAN,2013,LOCAL FLIGHTS,0,1,1
5,JAN,2013,LOCAL FLIGHTS,8,9,17
6,JAN,2013,LOCAL FLIGHTS,2,2,4
7,JAN,2013,LOCAL FLIGHTS,1,1,2
8,JAN,2013,LOCAL FLIGHTS,0,0,0
9,JAN,2013,LOCAL FLIGHTS,2,2,4
10,JAN,2013,LOCAL FLIGHTS,4,6,10
11,JAN,2013,LOCAL FLIGHTS,11,11,22
12,JAN,2013,LOCAL FLIGHTS,4,4,8
13,JAN,2013,LOCAL FLIGHTS,1,1,2
14,JAN,2013,LOCAL FLIGHTS,5,5,10
15,JAN,2013,LOCAL FLIGHTS,6,6,12
16,JAN,2013,LOCAL FLIGHTS,7,7,14
17,JAN,2013,LOCAL FLIGHTS,11,12,23
18,JAN,2013,LOCAL FLIGHTS,4,4,8
19,JAN,2013,LOCAL FLIGHTS,10,9,19
20,JAN,2013,LOCAL FLIGHTS,1,1,2
21,JAN,2013,LOCAL FLIGHTS,6,5,11
22,JAN,2013,LOCAL FLIGHTS,8,8,16
23,JAN,2013,LOCAL FLIGHTS,6,6,12
24,JAN,2013,LOCAL FLIGHTS,3,3,6
25,JAN,2013,LOCAL FLIGHTS,7,7,14
26,JAN,2013,LOCAL FLIGHTS,10,10,20
27,JAN,2013,LOCAL FLIGHTS,3,3,6
28,JAN,2013,LOCAL FLIGHTS,0,0,0
29,JAN,2013,LOCAL FLIGHTS,8,7,15
30,JAN,2013,LOCAL FLIGHTS,0,0,0
31,JAN,2013,LOCAL FLIGHTS,2,2,4
1,JAN,2013,HELICOPTER FLIGHTS,0,0,0
2,JAN,2013,HELICOPTER FLIGHTS,2,2,4
3,JAN,2013,HELICOPTER FLIGHTS,3,3,6
4,JAN,2013,HELICOPTER FLIGHTS,1,1,2
5,JAN,2013,HELICOPTER FLIGHTS,3,3,6
6,JAN,2013,HELICOPTER FLIGHTS,2,2,4
7,JAN,2013,HELICOPTER FLIGHTS,3,3,6
8,JAN,2013,HELICOPTER FLIGHTS,2,2,4
9,JAN,2013,HELICOPTER FLIGHTS,2,2,4
10,JAN,2013,HELICOPTER FLIGHTS,5,4,9
11,JAN,2013,HELICOPTER FLIGHTS,3,3,6
12,JAN,2013,HELICOPTER FLIGHTS,2,2,4
13,JAN,2013,HELICOPTER FLIGHTS,0,0,0
14,JAN,2013,HELICOPTER FLIGHTS,2,2,4
15,JAN,2013,HELICOPTER FLIGHTS,2,2,4
16,JAN,2013,HELICOPTER FLIGHTS,2,2,4
17,JAN,2013,HELICOPTER FLIGHTS,3,3,6
18,JAN,2013,HELICOPTER FLIGHTS,3,3,6
19,JAN,2013,HELICOPTER FLIGHTS,2,2,4
20,JAN,2013,HELICOPTER FLIGHTS,1,1,2
21,JAN,2013,HELICOPTER FLIGHTS,2,2,4
22,JAN,2013,HELICOPTER FLIGHTS,2,2,4
23,JAN,2013,HELICOPTER FLIGHTS,2,2,4
24,JAN,2013,HELICOPTER FLIGHTS,2,2,4
25,JAN,2013,HELICOPTER FLIGHTS,2,2,4
26,JAN,2013,HELICOPTER FLIGHTS,1,1,2
27,JAN,2013,HELICOPTER FLIGHTS,1,1,2
28,JAN,2013,HELICOPTER FLIGHTS,2,2,4
29,JAN,2013,HELICOPTER FLIGHTS,4,4,8
30,JAN,2013,HELICOPTER FLIGHTS,1,1,2
31,JAN,2013,HELICOPTER FLIGHTS,0,0,0
1,FEB,2013,INTERNATIONAL FLIGHTS,35,32,67
2,FEB,2013,INTERNATIONAL FLIGHTS,36,39,75
3,FEB,2013,INTERNATIONAL FLIGHTS,41,41,82
4,FEB,2013,INTERNATIONAL FLIGHTS,36,34,70
5,FEB,2013,INTERNATIONAL FLIGHTS,22,24,46
6,FEB,2013,INTERNATIONAL FLIGHTS,44,42,86
7,FEB,2013,INTERNATIONAL FLIGHTS,32,32,64
8,FEB,2013,INTERNATIONAL FLIGHTS,36,33,69
9,FEB,2013,INTERNATIONAL FLIGHTS,34,39,73
10,FEB,2013,INTERNATIONAL FLIGHTS,35,36,71
11,FEB,2013,INTERNATIONAL FLIGHTS,37,36,73
12,FEB,2013,INTERNATIONAL FLIGHTS,29,29,58
13,FEB,2013,INTERNATIONAL FLIGHTS,37,43,80
14,FEB,2013,INTERNATIONAL FLIGHTS,30,28,58
15,FEB,2013,INTERNATIONAL FLIGHTS,32,33,65
16,FEB,2013,INTERNATIONAL FLIGHTS,41,38,79
17,FEB,2013,INTERNATIONAL FLIGHTS,37,33,70
18,FEB,2013,INTERNATIONAL FLIGHTS,39,40,79
19,FEB,2013,INTERNATIONAL FLIGHTS,23,24,47
20,FEB,2013,INTERNATIONAL FLIGHTS,45,42,87
21,FEB,2013,INTERNATIONAL FLIGHTS,25,29,54
22,FEB,2013,INTERNATIONAL FLIGHTS,32,33,65
23,FEB,2013,INTERNATIONAL FLIGHTS,34,36,70
24,FEB,2013,INTERNATIONAL FLIGHTS,40,38,78
25,FEB,2013,INTERNATIONAL FLIGHTS,37,36,73
26,FEB,2013,INTERNATIONAL FLIGHTS,17,29,46
27,FEB,2013,INTERNATIONAL FLIGHTS,45,51,96
28,FEB,2013,INTERNATIONAL FLIGHTS,27,25,52
1,FEB,2013,LOCAL FLIGHTS,5,5,10
2,FEB,2013,LOCAL FLIGHTS,11,11,22
3,FEB,2013,LOCAL FLIGHTS,3,3,6
4,FEB,2013,LOCAL FLIGHTS,4,4,8
5,FEB,2013,LOCAL FLIGHTS,9,9,18
6,FEB,2013,LOCAL FLIGHTS,2,2,4
7,FEB,2013,LOCAL FLIGHTS,11,11,22
8,FEB,2013,LOCAL FLIGHTS,7,7,14
9,FEB,2013,LOCAL FLIGHTS,10,10,20
10,FEB,2013,LOCAL FLIGHTS,2,2,4
11,FEB,2013,LOCAL FLIGHTS,1,0,1
12,FEB,2013,LOCAL FLIGHTS,4,4,8
13,FEB,2013,LOCAL FLIGHTS,8,8,16
14,FEB,2013,LOCAL FLIGHTS,14,14,28
15,FEB,2013,LOCAL FLIGHTS,5,5,10
16,FEB,2013,LOCAL FLIGHTS,9,9,18
17,FEB,2013,LOCAL FLIGHTS,2,2,4
18,FEB,2013,LOCAL FLIGHTS,6,6,12
19,FEB,2013,LOCAL FLIGHTS,9,9,18
20,FEB,2013,LOCAL FLIGHTS,4,5,9
21,FEB,2013,LOCAL FLIGHTS,11,11,22
22,FEB,2013,LOCAL FLIGHTS,10,10,20
23,FEB,2013,LOCAL FLIGHTS,0,0,0
24,FEB,2013,LOCAL FLIGHTS,1,1,2
25,FEB,2013,LOCAL FLIGHTS,4,4,8
26,FEB,2013,LOCAL FLIGHTS,14,14,28
27,FEB,2013,LOCAL FLIGHTS,14,14,28
28,FEB,2013,LOCAL FLIGHTS,10,10,20
1,FEB,2013,HELICOPTER FLIGHTS,0,0,0
2,FEB,2013,HELICOPTER FLIGHTS,0,0,0
3,FEB,2013,HELICOPTER FLIGHTS,1,1,2
4,FEB,2013,HELICOPTER FLIGHTS,2,2,4
5,FEB,2013,HELICOPTER FLIGHTS,1,1,2
6,FEB,2013,HELICOPTER FLIGHTS,0,0,0
7,FEB,2013,HELICOPTER FLIGHTS,4,4,8
8,FEB,2013,HELICOPTER FLIGHTS,2,2,4
9,FEB,2013,HELICOPTER FLIGHTS,0,0,0
10,FEB,2013,HELICOPTER FLIGHTS,0,0,0
11,FEB,2013,HELICOPTER FLIGHTS,1,1,2
12,FEB,2013,HELICOPTER FLIGHTS,2,2,4
13,FEB,2013,HELICOPTER FLIGHTS,2,2,4
14,FEB,2013,HELICOPTER FLIGHTS,2,2,4
15,FEB,2013,HELICOPTER FLIGHTS,2,2,4
16,FEB,2013,HELICOPTER FLIGHTS,2,2,4
17,FEB,2013,HELICOPTER FLIGHTS,2,2,4
18,FEB,2013,HELICOPTER FLIGHTS,1,1,2
19,FEB,2013,HELICOPTER FLIGHTS,4,4,8
20,FEB,2013,HELICOPTER FLIGHTS,2,2,4
21,FEB,2013,HELICOPTER FLIGHTS,2,2,4
22,FEB,2013,HELICOPTER FLIGHTS,0,0,0
23,FEB,2013,HELICOPTER FLIGHTS,1,1,2
24,FEB,2013,HELICOPTER FLIGHTS,0,0,0
25,FEB,2013,HELICOPTER FLIGHTS,2,2,4
26,FEB,2013,HELICOPTER FLIGHTS,2,2,4
27,FEB,2013,HELICOPTER FLIGHTS,1,1,2
28,FEB,2013,HELICOPTER FLIGHTS,2,2,4
1,MAR,2013,INTERNATIONAL FLIGHTS,38,40,78
2,MAR,2013,INTERNATIONAL FLIGHTS,36,38,74
3,MAR,2013,INTERNATIONAL FLIGHTS,37,34,71
4,MAR,2013,INTERNATIONAL FLIGHTS,41,44,85
5,MAR,2013,INTERNATIONAL FLIGHTS,25,23,48
6,MAR,2013,INTERNATIONAL FLIGHTS,46,44,90
7,MAR,2013,INTERNATIONAL FLIGHTS,35,35,70
8,MAR,2013,INTERNATIONAL FLIGHTS,37,38,75
9,MAR,2013,INTERNATIONAL FLIGHTS,38,42,80
10,MAR,2013,INTERNATIONAL FLIGHTS,34,39,73
11,MAR,2013,INTERNATIONAL FLIGHTS,45,42,87
12,MAR,2013,INTERNATIONAL FLIGHTS,25,27,52
13,MAR,2013,INTERNATIONAL FLIGHTS,45,47,92
14,MAR,2013,INTERNATIONAL FLIGHTS,39,37,76
15,MAR,2013,INTERNATIONAL FLIGHTS,42,40,82
16,MAR,2013,INTERNATIONAL FLIGHTS,40,41,81
17,MAR,2013,INTERNATIONAL FLIGHTS,39,43,82
18,MAR,2013,INTERNATIONAL FLIGHTS,46,44,90
19,MAR,2013,INTERNATIONAL FLIGHTS,40,36,76
20,MAR,2013,INTERNATIONAL FLIGHTS,51,50,101
21,MAR,2013,INTERNATIONAL FLIGHTS,43,41,84
22,MAR,2013,INTERNATIONAL FLIGHTS,46,47,93
23,MAR,2013,INTERNATIONAL FLIGHTS,46,47,93
24,MAR,2013,INTERNATIONAL FLIGHTS,40,43,83
25,MAR,2013,INTERNATIONAL FLIGHTS,47,56,103
26,MAR,2013,INTERNATIONAL FLIGHTS,37,42,79
27,MAR,2013,INTERNATIONAL FLIGHTS,57,65,122
28,MAR,2013,INTERNATIONAL FLIGHTS,45,44,89
29,MAR,2013,INTERNATIONAL FLIGHTS,46,56,102
30,MAR,2013,INTERNATIONAL FLIGHTS,44,47,91
31,MAR,2013,INTERNATIONAL FLIGHTS,50,59,109
1,MAR,2013,LOCAL FLIGHTS,8,7,15
2,MAR,2013,LOCAL FLIGHTS,11,11,22
3,MAR,2013,LOCAL FLIGHTS,1,1,2
4,MAR,2013,LOCAL FLIGHTS,8,8,16
5,MAR,2013,LOCAL FLIGHTS,9,9,18
6,MAR,2013,LOCAL FLIGHTS,7,7,14
7,MAR,2013,LOCAL FLIGHTS,23,14,37
8,MAR,2013,LOCAL FLIGHTS,16,11,27
9,MAR,2013,LOCAL FLIGHTS,3,6,9
10,MAR,2013,LOCAL FLIGHTS,4,2,6
11,MAR,2013,LOCAL FLIGHTS,10,4,14
12,MAR,2013,LOCAL FLIGHTS,7,10,17
13,MAR,2013,LOCAL FLIGHTS,0,7,7
14,MAR,2013,LOCAL FLIGHTS,20,20,40
15,MAR,2013,LOCAL FLIGHTS,10,7,17
16,MAR,2013,LOCAL FLIGHTS,4,4,8
17,MAR,2013,LOCAL FLIGHTS,1,4,5
18,MAR,2013,LOCAL FLIGHTS,0,1,1
19,MAR,2013,LOCAL FLIGHTS,15,11,26
20,MAR,2013,LOCAL FLIGHTS,11,13,24
21,MAR,2013,LOCAL FLIGHTS,7,9,16
22,MAR,2013,LOCAL FLIGHTS,4,2,6
23,MAR,2013,LOCAL FLIGHTS,7,7,14
24,MAR,2013,LOCAL FLIGHTS,3,7,10
25,MAR,2013,LOCAL FLIGHTS,7,7,14
26,MAR,2013,LOCAL FLIGHTS,16,8,24
27,MAR,2013,LOCAL FLIGHTS,14,8,22
28,MAR,2013,LOCAL FLIGHTS,4,15,19
29,MAR,2013,LOCAL FLIGHTS,4,7,11
30,MAR,2013,LOCAL FLIGHTS,13,13,26
31,MAR,2013,LOCAL FLIGHTS,5,5,10
1,MAR,2013,HELICOPTER FLIGHTS,2,2,4
2,MAR,2013,HELICOPTER FLIGHTS,3,3,6
3,MAR,2013,HELICOPTER FLIGHTS,0,0,0
4,MAR,2013,HELICOPTER FLIGHTS,1,1,2
5,MAR,2013,HELICOPTER FLIGHTS,2,2,4
6,MAR,2013,HELICOPTER FLIGHTS,5,5,10
7,MAR,2013,HELICOPTER FLIGHTS,3,3,6
8,MAR,2013,HELICOPTER FLIGHTS,2,2,4
9,MAR,2013,HELICOPTER FLIGHTS,2,2,4
10,MAR,2013,HELICOPTER FLIGHTS,1,1,2
11,MAR,2013,HELICOPTER FLIGHTS,3,3,6
12,MAR,2013,HELICOPTER FLIGHTS,3,3,6
13,MAR,2013,HELICOPTER FLIGHTS,3,3,6
14,MAR,2013,HELICOPTER FLIGHTS,2,2,4
15,MAR,2013,HELICOPTER FLIGHTS,2,2,4
16,MAR,2013,HELICOPTER FLIGHTS,1,1,2
17,MAR,2013,HELICOPTER FLIGHTS,0,0,0
18,MAR,2013,HELICOPTER FLIGHTS,1,1,2
19,MAR,2013,HELICOPTER FLIGHTS,4,4,8
20,MAR,2013,HELICOPTER FLIGHTS,2,2,4
21,MAR,2013,HELICOPTER FLIGHTS,2,2,4
22,MAR,2013,HELICOPTER FLIGHTS,3,3,6
23,MAR,2013,HELICOPTER FLIGHTS,2,2,4
24,MAR,2013,HELICOPTER FLIGHTS,2,2,4
25,MAR,2013,HELICOPTER FLIGHTS,1,1,2
26,MAR,2013,HELICOPTER FLIGHTS,2,2,4
27,MAR,2013,HELICOPTER FLIGHTS,3,3,6
28,MAR,2013,HELICOPTER FLIGHTS,0,0,0
29,MAR,2013,HELICOPTER FLIGHTS,2,2,4
30,MAR,2013,HELICOPTER FLIGHTS,2,2,4
31,MAR,2013,HELICOPTER FLIGHTS,1,1,2
1,APR,2013,INTERNATIONAL FLIGHTS,56,55,111
2,APR,2013,INTERNATIONAL FLIGHTS,41,38,79
3,APR,2013,INTERNATIONAL FLIGHTS,53,55,108
4,APR,2013,INTERNATIONAL FLIGHTS,50,51,101
5,APR,2013,INTERNATIONAL FLIGHTS,49,48,97
6,APR,2013,INTERNATIONAL FLIGHTS,46,49,95
7,APR,2013,INTERNATIONAL FLIGHTS,50,51,101
8,APR,2013,INTERNATIONAL FLIGHTS,49,50,99
9,APR,2013,INTERNATIONAL FLIGHTS,32,33,65
10,APR,2013,INTERNATIONAL FLIGHTS,49,49,98
11,APR,2013,INTERNATIONAL FLIGHTS,48,47,95
12,APR,2013,INTERNATIONAL FLIGHTS,50,55,105
13,APR,2013,INTERNATIONAL FLIGHTS,45,48,93
14,APR,2013,INTERNATIONAL FLIGHTS,56,55,111
15,APR,2013,INTERNATIONAL FLIGHTS,51,53,104
16,APR,2013,INTERNATIONAL FLIGHTS,36,35,71
17,APR,2013,INTERNATIONAL FLIGHTS,54,55,109
18,APR,2013,INTERNATIONAL FLIGHTS,53,56,109
19,APR,2013,INTERNATIONAL FLIGHTS,57,60,117
20,APR,2013,INTERNATIONAL FLIGHTS,47,46,93
21,APR,2013,INTERNATIONAL FLIGHTS,64,58,122
22,APR,2013,INTERNATIONAL FLIGHTS,60,58,118
23,APR,2013,INTERNATIONAL FLIGHTS,39,44,83
24,APR,2013,INTERNATIONAL FLIGHTS,55,55,110
25,APR,2013,INTERNATIONAL FLIGHTS,53,49,102
26,APR,2013,INTERNATIONAL FLIGHTS,67,69,136
27,APR,2013,INTERNATIONAL FLIGHTS,56,58,114
28,APR,2013,INTERNATIONAL FLIGHTS,71,69,140
29,APR,2013,INTERNATIONAL FLIGHTS,70,70,140
30,APR,2013,INTERNATIONAL FLIGHTS,53,51,104
1,APR,2013,LOCAL FLIGHTS,8,8,16
2,APR,2013,LOCAL FLIGHTS,4,3,7
3,APR,2013,LOCAL FLIGHTS,14,14,28
4,APR,2013,LOCAL FLIGHTS,3,3,6
5,APR,2013,LOCAL FLIGHTS,9,9,18
6,APR,2013,LOCAL FLIGHTS,13,14,27
7,APR,2013,LOCAL FLIGHTS,3,3,6
8,APR,2013,LOCAL FLIGHTS,4,4,8
9,APR,2013,LOCAL FLIGHTS,8,8,16
10,APR,2013,LOCAL FLIGHTS,10,11,21
11,APR,2013,LOCAL FLIGHTS,3,3,6
12,APR,2013,LOCAL FLIGHTS,8,7,15
13,APR,2013,LOCAL FLIGHTS,8,8,16
14,APR,2013,LOCAL FLIGHTS,9,9,18
15,APR,2013,LOCAL FLIGHTS,10,10,20
16,APR,2013,LOCAL FLIGHTS,9,10,19
17,APR,2013,LOCAL FLIGHTS,11,11,22
18,APR,2013,LOCAL FLIGHTS,10,10,20
19,APR,2013,LOCAL FLIGHTS,9,9,18
20,APR,2013,LOCAL FLIGHTS,8,8,16
21,APR,2013,LOCAL FLIGHTS,5,5,10
22,APR,2013,LOCAL FLIGHTS,7,7,14
23,APR,2013,LOCAL FLIGHTS,11,11,22
24,APR,2013,LOCAL FLIGHTS,13,13,26
25,APR,2013,LOCAL FLIGHTS,9,9,18
26,APR,2013,LOCAL FLIGHTS,11,11,22
27,APR,2013,LOCAL FLIGHTS,14,14,28
28,APR,2013,LOCAL FLIGHTS,3,3,6
29,APR,2013,LOCAL FLIGHTS,10,10,20
30,APR,2013,LOCAL FLIGHTS,10,9,19
1,APR,2013,HELICOPTER FLIGHTS,1,1,2
2,APR,2013,HELICOPTER FLIGHTS,2,2,4
3,APR,2013,HELICOPTER FLIGHTS,3,3,6
4,APR,2013,HELICOPTER FLIGHTS,2,2,4
5,APR,2013,HELICOPTER FLIGHTS,2,2,4
6,APR,2013,HELICOPTER FLIGHTS,2,2,4
7,APR,2013,HELICOPTER FLIGHTS,1,1,2
8,APR,2013,HELICOPTER FLIGHTS,1,1,2
9,APR,2013,HELICOPTER FLIGHTS,2,2,4
10,APR,2013,HELICOPTER FLIGHTS,2,2,4
11,APR,2013,HELICOPTER FLIGHTS,3,3,6
12,APR,2013,HELICOPTER FLIGHTS,1,1,2
13,APR,2013,HELICOPTER FLIGHTS,2,2,4
14,APR,2013,HELICOPTER FLIGHTS,1,1,2
15,APR,2013,HELICOPTER FLIGHTS,2,2,4
16,APR,2013,HELICOPTER FLIGHTS,2,2,4
17,APR,2013,HELICOPTER FLIGHTS,0,0,0
18,APR,2013,HELICOPTER FLIGHTS,3,3,6
19,APR,2013,HELICOPTER FLIGHTS,2,2,4
20,APR,2013,HELICOPTER FLIGHTS,2,2,4
21,APR,2013,HELICOPTER FLIGHTS,1,1,2
22,APR,2013,HELICOPTER FLIGHTS,1,1,2
23,APR,2013,HELICOPTER FLIGHTS,4,4,8
24,APR,2013,HELICOPTER FLIGHTS,2,2,4
25,APR,2013,HELICOPTER FLIGHTS,1,1,2
26,APR,2013,HELICOPTER FLIGHTS,2,2,4
27,APR,2013,HELICOPTER FLIGHTS,2,2,4
28,APR,2013,HELICOPTER FLIGHTS,3,3,6
29,APR,2013,HELICOPTER FLIGHTS,3,3,6
30,APR,2013,HELICOPTER FLIGHTS,3,3,6
1,MAY,2013,INTERNATIONAL FLIGHTS,74,79,153
2,MAY,2013,INTERNATIONAL FLIGHTS,59,60,119
3,MAY,2013,INTERNATIONAL FLIGHTS,70,75,145
4,MAY,2013,INTERNATIONAL FLIGHTS,63,60,123
5,MAY,2013,INTERNATIONAL FLIGHTS,78,76,154
6,MAY,2013,INTERNATIONAL FLIGHTS,74,80,154
7,MAY,2013,INTERNATIONAL FLIGHTS,49,49,98
8,MAY,2013,INTERNATIONAL FLIGHTS,77,74,151
9,MAY,2013,INTERNATIONAL FLIGHTS,60,58,118
10,MAY,2013,INTERNATIONAL FLIGHTS,68,77,145
11,MAY,2013,INTERNATIONAL FLIGHTS,68,66,134
12,MAY,2013,INTERNATIONAL FLIGHTS,83,85,168
13,MAY,2013,INTERNATIONAL FLIGHTS,74,80,154
14,MAY,2013,INTERNATIONAL FLIGHTS,44,45,89
15,MAY,2013,INTERNATIONAL FLIGHTS,68,70,138
16,MAY,2013,INTERNATIONAL FLIGHTS,62,57,119
17,MAY,2013,INTERNATIONAL FLIGHTS,71,72,143
18,MAY,2013,INTERNATIONAL FLIGHTS,62,64,126
19,MAY,2013,INTERNATIONAL FLIGHTS,77,77,154
20,MAY,2013,INTERNATIONAL FLIGHTS,72,75,147
21,MAY,2013,INTERNATIONAL FLIGHTS,47,50,97
22,MAY,2013,INTERNATIONAL FLIGHTS,62,64,126
23,MAY,2013,INTERNATIONAL FLIGHTS,59,56,115
24,MAY,2013,INTERNATIONAL FLIGHTS,75,73,148
25,MAY,2013,INTERNATIONAL FLIGHTS,60,58,118
26,MAY,2013,INTERNATIONAL FLIGHTS,82,84,166
27,MAY,2013,INTERNATIONAL FLIGHTS,73,77,150
28,MAY,2013,INTERNATIONAL FLIGHTS,46,46,92
29,MAY,2013,INTERNATIONAL FLIGHTS,73,73,146
30,MAY,2013,INTERNATIONAL FLIGHTS,61,59,120
31,MAY,2013,INTERNATIONAL FLIGHTS,73,79,152
1,MAY,2013,LOCAL FLIGHTS,9,9,18
2,MAY,2013,LOCAL FLIGHTS,2,2,4
3,MAY,2013,LOCAL FLIGHTS,4,4,8
4,MAY,2013,LOCAL FLIGHTS,2,2,4
5,MAY,2013,LOCAL FLIGHTS,0,0,0
6,MAY,2013,LOCAL FLIGHTS,0,0,0
7,MAY,2013,LOCAL FLIGHTS,7,7,14
8,MAY,2013,LOCAL FLIGHTS,0,0,0
9,MAY,2013,LOCAL FLIGHTS,5,6,11
10,MAY,2013,LOCAL FLIGHTS,11,4,15
11,MAY,2013,LOCAL FLIGHTS,5,5,10
12,MAY,2013,LOCAL FLIGHTS,0,0,0
13,MAY,2013,LOCAL FLIGHTS,2,2,4
14,MAY,2013,LOCAL FLIGHTS,5,5,10
15,MAY,2013,LOCAL FLIGHTS,3,3,6
16,MAY,2013,LOCAL FLIGHTS,6,5,11
17,MAY,2013,LOCAL FLIGHTS,2,2,4
18,MAY,2013,LOCAL FLIGHTS,11,10,21
19,MAY,2013,LOCAL FLIGHTS,0,0,0
20,MAY,2013,LOCAL FLIGHTS,5,5,10
21,MAY,2013,LOCAL FLIGHTS,7,7,14
22,MAY,2013,LOCAL FLIGHTS,6,6,12
23,MAY,2013,LOCAL FLIGHTS,11,12,23
24,MAY,2013,LOCAL FLIGHTS,5,5,10
25,MAY,2013,LOCAL FLIGHTS,12,12,24
26,MAY,2013,LOCAL FLIGHTS,8,8,16
27,MAY,2013,LOCAL FLIGHTS,13,12,25
28,MAY,2013,LOCAL FLIGHTS,9,9,18
29,MAY,2013,LOCAL FLIGHTS,6,6,12
30,MAY,2013,LOCAL FLIGHTS,2,2,4
31,MAY,2013,LOCAL FLIGHTS,8,8,16
1,MAY,2013,HELICOPTER FLIGHTS,2,2,4
2,MAY,2013,HELICOPTER FLIGHTS,4,4,8
3,MAY,2013,HELICOPTER FLIGHTS,0,0,0
4,MAY,2013,HELICOPTER FLIGHTS,1,1,2
5,MAY,2013,HELICOPTER FLIGHTS,1,1,2
6,MAY,2013,HELICOPTER FLIGHTS,1,1,2
7,MAY,2013,HELICOPTER FLIGHTS,3,2,5
8,MAY,2013,HELICOPTER FLIGHTS,3,3,6
9,MAY,2013,HELICOPTER FLIGHTS,2,2,4
10,MAY,2013,HELICOPTER FLIGHTS,2,2,4
11,MAY,2013,HELICOPTER FLIGHTS,1,1,2
12,MAY,2013,HELICOPTER FLIGHTS,1,1,2
13,MAY,2013,HELICOPTER FLIGHTS,3,3,6
14,MAY,2013,HELICOPTER FLIGHTS,4,4,8
15,MAY,2013,HELICOPTER FLIGHTS,2,2,4
16,MAY,2013,HELICOPTER FLIGHTS,3,3,6
17,MAY,2013,HELICOPTER FLIGHTS,2,2,4
18,MAY,2013,HELICOPTER FLIGHTS,2,2,4
19,MAY,2013,HELICOPTER FLIGHTS,1,1,2
20,MAY,2013,HELICOPTER FLIGHTS,2,2,4
21,MAY,2013,HELICOPTER FLIGHTS,2,2,4
22,MAY,2013,HELICOPTER FLIGHTS,2,2,4
23,MAY,2013,HELICOPTER FLIGHTS,1,1,2
24,MAY,2013,HELICOPTER FLIGHTS,3,3,6
25,MAY,2013,HELICOPTER FLIGHTS,2,2,4
26,MAY,2013,HELICOPTER FLIGHTS,1,1,2
27,MAY,2013,HELICOPTER FLIGHTS,2,2,4
28,MAY,2013,HELICOPTER FLIGHTS,2,2,4
29,MAY,2013,HELICOPTER FLIGHTS,3,3,6
30,MAY,2013,HELICOPTER FLIGHTS,2,2,4
31,MAY,2013,HELICOPTER FLIGHTS,2,3,5
1,JUN,2013,INTERNATIONAL FLIGHTS,67,66,133
2,JUN,2013,INTERNATIONAL FLIGHTS,84,88,172
3,JUN,2013,INTERNATIONAL FLIGHTS,73,72,145
4,JUN,2013,INTERNATIONAL FLIGHTS,45,42,87
5,JUN,2013,INTERNATIONAL FLIGHTS,73,72,145
6,JUN,2013,INTERNATIONAL FLIGHTS,55,54,109
7,JUN,2013,INTERNATIONAL FLIGHTS,79,81,160
8,JUN,2013,INTERNATIONAL FLIGHTS,61,63,124
9,JUN,2013,INTERNATIONAL FLIGHTS,89,84,173
10,JUN,2013,INTERNATIONAL FLIGHTS,84,92,176
11,JUN,2013,INTERNATIONAL FLIGHTS,47,51,98
12,JUN,2013,INTERNATIONAL FLIGHTS,77,74,151
13,JUN,2013,INTERNATIONAL FLIGHTS,56,56,112
14,JUN,2013,INTERNATIONAL FLIGHTS,71,73,144
15,JUN,2013,INTERNATIONAL FLIGHTS,66,71,137
16,JUN,2013,INTERNATIONAL FLIGHTS,85,85,170
17,JUN,2013,INTERNATIONAL FLIGHTS,74,78,152
18,JUN,2013,INTERNATIONAL FLIGHTS,51,45,96
19,JUN,2013,INTERNATIONAL FLIGHTS,79,78,157
20,JUN,2013,INTERNATIONAL FLIGHTS,63,60,123
21,JUN,2013,INTERNATIONAL FLIGHTS,83,89,172
22,JUN,2013,INTERNATIONAL FLIGHTS,64,67,131
23,JUN,2013,INTERNATIONAL FLIGHTS,94,99,193
24,JUN,2013,INTERNATIONAL FLIGHTS,85,81,166
25,JUN,2013,INTERNATIONAL FLIGHTS,51,49,100
26,JUN,2013,INTERNATIONAL FLIGHTS,87,83,170
27,JUN,2013,INTERNATIONAL FLIGHTS,57,57,114
28,JUN,2013,INTERNATIONAL FLIGHTS,87,83,170
29,JUN,2013,INTERNATIONAL FLIGHTS,69,71,140
30,JUN,2013,INTERNATIONAL FLIGHTS,87,90,177
1,JUN,2013,LOCAL FLIGHTS,10,10,20
2,JUN,2013,LOCAL FLIGHTS,1,1,2
3,JUN,2013,LOCAL FLIGHTS,8,8,16
4,JUN,2013,LOCAL FLIGHTS,7,8,15
5,JUN,2013,LOCAL FLIGHTS,5,5,10
6,JUN,2013,LOCAL FLIGHTS,4,4,8
7,JUN,2013,LOCAL FLIGHTS,7,6,13
8,JUN,2013,LOCAL FLIGHTS,7,7,14
9,JUN,2013,LOCAL FLIGHTS,2,1,3
10,JUN,2013,LOCAL FLIGHTS,5,5,10
11,JUN,2013,LOCAL FLIGHTS,4,4,8
12,JUN,2013,LOCAL FLIGHTS,8,8,16
13,JUN,2013,LOCAL FLIGHTS,2,2,4
14,JUN,2013,LOCAL FLIGHTS,11,11,22
15,JUN,2013,LOCAL FLIGHTS,7,7,14
16,JUN,2013,LOCAL FLIGHTS,2,2,4
17,JUN,2013,LOCAL FLIGHTS,2,2,4
18,JUN,2013,LOCAL FLIGHTS,8,7,15
19,JUN,2013,LOCAL FLIGHTS,12,12,24
20,JUN,2013,LOCAL FLIGHTS,10,8,18
21,JUN,2013,LOCAL FLIGHTS,7,8,15
22,JUN,2013,LOCAL FLIGHTS,6,7,13
23,JUN,2013,LOCAL FLIGHTS,0,0,0
24,JUN,2013,LOCAL FLIGHTS,2,2,4
25,JUN,2013,LOCAL FLIGHTS,8,8,16
26,JUN,2013,LOCAL FLIGHTS,8,9,17
27,JUN,2013,LOCAL FLIGHTS,5,6,11
28,JUN,2013,LOCAL FLIGHTS,4,4,8
29,JUN,2013,LOCAL FLIGHTS,4,4,8
30,JUN,2013,LOCAL FLIGHTS,2,2,4
1,JUN,2013,HELICOPTER FLIGHTS,2,2,4
2,JUN,2013,HELICOPTER FLIGHTS,1,1,2
3,JUN,2013,HELICOPTER FLIGHTS,2,2,4
4,JUN,2013,HELICOPTER FLIGHTS,6,6,12
5,JUN,2013,HELICOPTER FLIGHTS,3,3,6
6,JUN,2013,HELICOPTER FLIGHTS,2,2,4
7,JUN,2013,HELICOPTER FLIGHTS,2,2,4
8,JUN,2013,HELICOPTER FLIGHTS,2,2,4
9,JUN,2013,HELICOPTER FLIGHTS,1,1,2
10,JUN,2013,HELICOPTER FLIGHTS,1,1,2
11,JUN,2013,HELICOPTER FLIGHTS,3,3,6
12,JUN,2013,HELICOPTER FLIGHTS,2,2,4
13,JUN,2013,HELICOPTER FLIGHTS,1,1,2
14,JUN,2013,HELICOPTER FLIGHTS,3,3,6
15,JUN,2013,HELICOPTER FLIGHTS,3,3,6
16,JUN,2013,HELICOPTER FLIGHTS,1,1,2
17,JUN,2013,HELICOPTER FLIGHTS,3,2,5
18,JUN,2013,HELICOPTER FLIGHTS,1,1,2
19,JUN,2013,HELICOPTER FLIGHTS,6,6,12
20,JUN,2013,HELICOPTER FLIGHTS,5,5,10
21,JUN,2013,HELICOPTER FLIGHTS,6,6,12
22,JUN,2013,HELICOPTER FLIGHTS,2,2,4
23,JUN,2013,HELICOPTER FLIGHTS,1,1,2
24,JUN,2013,HELICOPTER FLIGHTS,2,2,4
25,JUN,2013,HELICOPTER FLIGHTS,1,1,2
26,JUN,2013,HELICOPTER FLIGHTS,2,2,4
27,JUN,2013,HELICOPTER FLIGHTS,2,2,4
28,JUN,2013,HELICOPTER FLIGHTS,2,2,4
29,JUN,2013,HELICOPTER FLIGHTS,2,2,4
30,JUN,2013,HELICOPTER FLIGHTS,1,1,2
1,JUL,2013,INTERNATIONAL FLIGHTS,89,86,175
2,JUL,2013,INTERNATIONAL FLIGHTS,54,55,109
3,JUL,2013,INTERNATIONAL FLIGHTS,79,80,159
4,JUL,2013,INTERNATIONAL FLIGHTS,62,61,123
5,JUL,2013,INTERNATIONAL FLIGHTS,84,86,170
6,JUL,2013,INTERNATIONAL FLIGHTS,73,70,143
7,JUL,2013,INTERNATIONAL FLIGHTS,87,90,177
8,JUL,2013,INTERNATIONAL FLIGHTS,85,85,170
9,JUL,2013,INTERNATIONAL FLIGHTS,56,54,110
10,JUL,2013,INTERNATIONAL FLIGHTS,80,84,164
11,JUL,2013,INTERNATIONAL FLIGHTS,75,73,148
12,JUL,2013,INTERNATIONAL FLIGHTS,81,84,165
13,JUL,2013,INTERNATIONAL FLIGHTS,66,67,133
14,JUL,2013,INTERNATIONAL FLIGHTS,86,87,173
15,JUL,2013,INTERNATIONAL FLIGHTS,87,86,173
16,JUL,2013,INTERNATIONAL FLIGHTS,56,56,112
17,JUL,2013,INTERNATIONAL FLIGHTS,84,86,170
18,JUL,2013,INTERNATIONAL FLIGHTS,63,61,124
19,JUL,2013,INTERNATIONAL FLIGHTS,83,81,164
20,JUL,2013,INTERNATIONAL FLIGHTS,62,69,131
21,JUL,2013,INTERNATIONAL FLIGHTS,86,86,172
22,JUL,2013,INTERNATIONAL FLIGHTS,83,82,165
23,JUL,2013,INTERNATIONAL FLIGHTS,63,58,121
24,JUL,2013,INTERNATIONAL FLIGHTS,75,85,160
25,JUL,2013,INTERNATIONAL FLIGHTS,61,58,119
26,JUL,2013,INTERNATIONAL FLIGHTS,84,84,168
27,JUL,2013,INTERNATIONAL FLIGHTS,62,66,128
28,JUL,2013,INTERNATIONAL FLIGHTS,86,86,172
29,JUL,2013,INTERNATIONAL FLIGHTS,88,87,175
30,JUL,2013,INTERNATIONAL FLIGHTS,52,54,106
31,JUL,2013,INTERNATIONAL FLIGHTS,80,79,159
1,JUL,2013,LOCAL FLIGHTS,3,3,6
2,JUL,2013,LOCAL FLIGHTS,7,6,13
3,JUL,2013,LOCAL FLIGHTS,6,6,12
4,JUL,2013,LOCAL FLIGHTS,8,9,17
5,JUL,2013,LOCAL FLIGHTS,3,3,6
6,JUL,2013,LOCAL FLIGHTS,15,15,30
7,JUL,2013,LOCAL FLIGHTS,1,1,2
8,JUL,2013,LOCAL FLIGHTS,2,2,4
9,JUL,2013,LOCAL FLIGHTS,4,4,8
10,JUL,2013,LOCAL FLIGHTS,4,4,8
11,JUL,2013,LOCAL FLIGHTS,3,3,6
12,JUL,2013,LOCAL FLIGHTS,8,8,16
13,JUL,2013,LOCAL FLIGHTS,9,9,18
14,JUL,2013,LOCAL FLIGHTS,1,1,2
15,JUL,2013,LOCAL FLIGHTS,7,7,14
16,JUL,2013,LOCAL FLIGHTS,4,4,8
17,JUL,2013,LOCAL FLIGHTS,6,6,12
18,JUL,2013,LOCAL FLIGHTS,6,6,12
19,JUL,2013,LOCAL FLIGHTS,8,8,16
20,JUL,2013,LOCAL FLIGHTS,14,14,28
21,JUL,2013,LOCAL FLIGHTS,2,2,4
22,JUL,2013,LOCAL FLIGHTS,6,6,12
23,JUL,2013,LOCAL FLIGHTS,10,10,20
24,JUL,2013,LOCAL FLIGHTS,9,9,18
25,JUL,2013,LOCAL FLIGHTS,9,9,18
26,JUL,2013,LOCAL FLIGHTS,4,4,8
27,JUL,2013,LOCAL FLIGHTS,12,11,23
28,JUL,2013,LOCAL FLIGHTS,1,1,2
29,JUL,2013,LOCAL FLIGHTS,6,6,12
30,JUL,2013,LOCAL FLIGHTS,6,6,12
31,JUL,2013,LOCAL FLIGHTS,10,10,20
1,JUL,2013,HELICOPTER FLIGHTS,2,2,4
2,JUL,2013,HELICOPTER FLIGHTS,1,1,2
3,JUL,2013,HELICOPTER FLIGHTS,4,4,8
4,JUL,2013,HELICOPTER FLIGHTS,3,3,6
5,JUL,2013,HELICOPTER FLIGHTS,1,1,2
6,JUL,2013,HELICOPTER FLIGHTS,2,2,4
7,JUL,2013,HELICOPTER FLIGHTS,1,1,2
8,JUL,2013,HELICOPTER FLIGHTS,1,1,2
9,JUL,2013,HELICOPTER FLIGHTS,2,2,4
10,JUL,2013,HELICOPTER FLIGHTS,2,2,4
11,JUL,2013,HELICOPTER FLIGHTS,4,5,9
12,JUL,2013,HELICOPTER FLIGHTS,3,3,6
13,JUL,2013,HELICOPTER FLIGHTS,1,1,2
14,JUL,2013,HELICOPTER FLIGHTS,1,1,2
15,JUL,2013,HELICOPTER FLIGHTS,2,2,4
16,JUL,2013,HELICOPTER FLIGHTS,1,1,2
17,JUL,2013,HELICOPTER FLIGHTS,2,2,4
18,JUL,2013,HELICOPTER FLIGHTS,3,3,6
19,JUL,2013,HELICOPTER FLIGHTS,2,2,4
20,JUL,2013,HELICOPTER FLIGHTS,3,3,6
21,JUL,2013,HELICOPTER FLIGHTS,1,1,2
22,JUL,2013,HELICOPTER FLIGHTS,2,2,4
23,JUL,2013,HELICOPTER FLIGHTS,1,1,2
24,JUL,2013,HELICOPTER FLIGHTS,2,2,4
25,JUL,2013,HELICOPTER FLIGHTS,2,2,4
26,JUL,2013,HELICOPTER FLIGHTS,2,2,4
27,JUL,2013,HELICOPTER FLIGHTS,2,3,5
28,JUL,2013,HELICOPTER FLIGHTS,1,1,2
29,JUL,2013,HELICOPTER FLIGHTS,2,2,4
30,JUL,2013,HELICOPTER FLIGHTS,3,3,6
31,JUL,2013,HELICOPTER FLIGHTS,4,5,9
1,AUG,2013,INTERNATIONAL FLIGHTS,68,67,135
2,AUG,2013,INTERNATIONAL FLIGHTS,80,82,162
3,AUG,2013,INTERNATIONAL FLIGHTS,67,67,134
4,AUG,2013,INTERNATIONAL FLIGHTS,89,90,179
5,AUG,2013,INTERNATIONAL FLIGHTS,88,82,170
6,AUG,2013,INTERNATIONAL FLIGHTS,62,66,128
7,AUG,2013,INTERNATIONAL FLIGHTS,87,83,170
8,AUG,2013,INTERNATIONAL FLIGHTS,60,61,121
9,AUG,2013,INTERNATIONAL FLIGHTS,83,81,164
10,AUG,2013,INTERNATIONAL FLIGHTS,70,70,140
11,AUG,2013,INTERNATIONAL FLIGHTS,92,93,185
12,AUG,2013,INTERNATIONAL FLIGHTS,84,104,188
13,AUG,2013,INTERNATIONAL FLIGHTS,57,58,115
14,AUG,2013,INTERNATIONAL FLIGHTS,91,86,177
15,AUG,2013,INTERNATIONAL FLIGHTS,55,54,109
16,AUG,2013,INTERNATIONAL FLIGHTS,84,83,167
17,AUG,2013,INTERNATIONAL FLIGHTS,67,69,136
18,AUG,2013,INTERNATIONAL FLIGHTS,90,93,183
19,AUG,2013,INTERNATIONAL FLIGHTS,81,83,164
20,AUG,2013,INTERNATIONAL FLIGHTS,56,56,112
21,AUG,2013,INTERNATIONAL FLIGHTS,80,81,161
22,AUG,2013,INTERNATIONAL FLIGHTS,61,61,122
23,AUG,2013,INTERNATIONAL FLIGHTS,84,88,172
24,AUG,2013,INTERNATIONAL FLIGHTS,69,67,136
25,AUG,2013,INTERNATIONAL FLIGHTS,86,89,175
26,AUG,2013,INTERNATIONAL FLIGHTS,87,90,177
27,AUG,2013,INTERNATIONAL FLIGHTS,53,53,106
28,AUG,2013,INTERNATIONAL FLIGHTS,86,84,170
29,AUG,2013,INTERNATIONAL FLIGHTS,57,55,112
30,AUG,2013,INTERNATIONAL FLIGHTS,85,83,168
31,AUG,2013,INTERNATIONAL FLIGHTS,67,70,137
1,AUG,2013,LOCAL FLIGHTS,11,11,22
2,AUG,2013,LOCAL FLIGHTS,6,6,12
3,AUG,2013,LOCAL FLIGHTS,10,10,20
4,AUG,2013,LOCAL FLIGHTS,2,2,4
5,AUG,2013,LOCAL FLIGHTS,7,7,14
6,AUG,2013,LOCAL FLIGHTS,13,13,26
7,AUG,2013,LOCAL FLIGHTS,5,5,10
8,AUG,2013,LOCAL FLIGHTS,12,12,24
9,AUG,2013,LOCAL FLIGHTS,6,6,12
10,AUG,2013,LOCAL FLIGHTS,11,11,22
11,AUG,2013,LOCAL FLIGHTS,3,3,6
12,AUG,2013,LOCAL FLIGHTS,7,7,14
13,AUG,2013,LOCAL FLIGHTS,5,5,10
14,AUG,2013,LOCAL FLIGHTS,6,6,12
15,AUG,2013,LOCAL FLIGHTS,4,4,8
16,AUG,2013,LOCAL FLIGHTS,13,13,26
17,AUG,2013,LOCAL FLIGHTS,11,11,22
18,AUG,2013,LOCAL FLIGHTS,6,5,11
19,AUG,2013,LOCAL FLIGHTS,5,5,10
20,AUG,2013,LOCAL FLIGHTS,9,9,18
21,AUG,2013,LOCAL FLIGHTS,12,12,24
22,AUG,2013,LOCAL FLIGHTS,4,4,8
23,AUG,2013,LOCAL FLIGHTS,8,9,17
24,AUG,2013,LOCAL FLIGHTS,11,11,22
25,AUG,2013,LOCAL FLIGHTS,3,3,6
26,AUG,2013,LOCAL FLIGHTS,8,8,16
27,AUG,2013,LOCAL FLIGHTS,11,11,22
28,AUG,2013,LOCAL FLIGHTS,6,6,12
29,AUG,2013,LOCAL FLIGHTS,7,7,14
30,AUG,2013,LOCAL FLIGHTS,9,8,17
31,AUG,2013,LOCAL FLIGHTS,11,11,22
1,AUG,2013,HELICOPTER FLIGHTS,0,0,0
2,AUG,2013,HELICOPTER FLIGHTS,1,1,2
3,AUG,2013,HELICOPTER FLIGHTS,1,1,2
4,AUG,2013,HELICOPTER FLIGHTS,1,1,2
5,AUG,2013,HELICOPTER FLIGHTS,2,2,4
6,AUG,2013,HELICOPTER FLIGHTS,2,2,4
7,AUG,2013,HELICOPTER FLIGHTS,1,1,2
8,AUG,2013,HELICOPTER FLIGHTS,1,1,2
9,AUG,2013,HELICOPTER FLIGHTS,3,3,6
10,AUG,2013,HELICOPTER FLIGHTS,1,1,2
11,AUG,2013,HELICOPTER FLIGHTS,1,1,2
12,AUG,2013,HELICOPTER FLIGHTS,1,1,2
13,AUG,2013,HELICOPTER FLIGHTS,2,2,4
14,AUG,2013,HELICOPTER FLIGHTS,1,1,2
15,AUG,2013,HELICOPTER FLIGHTS,1,1,2
16,AUG,2013,HELICOPTER FLIGHTS,3,3,6
17,AUG,2013,HELICOPTER FLIGHTS,4,4,8
18,AUG,2013,HELICOPTER FLIGHTS,3,4,7
19,AUG,2013,HELICOPTER FLIGHTS,2,2,4
20,AUG,2013,HELICOPTER FLIGHTS,4,4,8
21,AUG,2013,HELICOPTER FLIGHTS,2,2,4
22,AUG,2013,HELICOPTER FLIGHTS,2,2,4
23,AUG,2013,HELICOPTER FLIGHTS,1,1,2
24,AUG,2013,HELICOPTER FLIGHTS,2,2,4
25,AUG,2013,HELICOPTER FLIGHTS,2,2,4
26,AUG,2013,HELICOPTER FLIGHTS,1,1,2
27,AUG,2013,HELICOPTER FLIGHTS,1,1,2
28,AUG,2013,HELICOPTER FLIGHTS,2,2,4
29,AUG,2013,HELICOPTER FLIGHTS,0,0,0
30,AUG,2013,HELICOPTER FLIGHTS,1,1,2
31,AUG,2013,HELICOPTER FLIGHTS,3,3,6
1,SEP,2013,INTERNATIONAL FLIGHTS,90,88,178
2,SEP,2013,INTERNATIONAL FLIGHTS,83,80,163
3,SEP,2013,INTERNATIONAL FLIGHTS,49,49,98
4,SEP,2013,INTERNATIONAL FLIGHTS,77,81,158
5,SEP,2013,INTERNATIONAL FLIGHTS,56,52,108
6,SEP,2013,INTERNATIONAL FLIGHTS,76,79,155
7,SEP,2013,INTERNATIONAL FLIGHTS,66,68,134
8,SEP,2013,INTERNATIONAL FLIGHTS,92,92,184
9,SEP,2013,INTERNATIONAL FLIGHTS,86,89,175
10,SEP,2013,INTERNATIONAL FLIGHTS,53,58,111
11,SEP,2013,INTERNATIONAL FLIGHTS,81,83,164
12,SEP,2013,INTERNATIONAL FLIGHTS,58,55,113
13,SEP,2013,INTERNATIONAL FLIGHTS,82,86,168
14,SEP,2013,INTERNATIONAL FLIGHTS,68,75,143
15,SEP,2013,INTERNATIONAL FLIGHTS,87,84,171
16,SEP,2013,INTERNATIONAL FLIGHTS,82,81,163
17,SEP,2013,INTERNATIONAL FLIGHTS,52,53,105
18,SEP,2013,INTERNATIONAL FLIGHTS,83,87,170
19,SEP,2013,INTERNATIONAL FLIGHTS,64,58,122
20,SEP,2013,INTERNATIONAL FLIGHTS,80,82,162
21,SEP,2013,INTERNATIONAL FLIGHTS,69,68,137
22,SEP,2013,INTERNATIONAL FLIGHTS,87,91,178
23,SEP,2013,INTERNATIONAL FLIGHTS,78,81,159
24,SEP,2013,INTERNATIONAL FLIGHTS,52,49,101
25,SEP,2013,INTERNATIONAL FLIGHTS,84,80,164
26,SEP,2013,INTERNATIONAL FLIGHTS,54,55,109
27,SEP,2013,INTERNATIONAL FLIGHTS,77,81,158
28,SEP,2013,INTERNATIONAL FLIGHTS,63,69,132
29,SEP,2013,INTERNATIONAL FLIGHTS,86,90,176
30,SEP,2013,INTERNATIONAL FLIGHTS,76,76,152
1,SEP,2013,LOCAL FLIGHTS,1,1,2
2,SEP,2013,LOCAL FLIGHTS,6,6,12
3,SEP,2013,LOCAL FLIGHTS,7,7,14
4,SEP,2013,LOCAL FLIGHTS,8,8,16
5,SEP,2013,LOCAL FLIGHTS,10,10,20
6,SEP,2013,LOCAL FLIGHTS,17,18,35
7,SEP,2013,LOCAL FLIGHTS,16,17,33
8,SEP,2013,LOCAL FLIGHTS,8,8,16
9,SEP,2013,LOCAL FLIGHTS,14,14,28
10,SEP,2013,LOCAL FLIGHTS,14,14,28
11,SEP,2013,LOCAL FLIGHTS,12,12,24
12,SEP,2013,LOCAL FLIGHTS,16,16,32
13,SEP,2013,LOCAL FLIGHTS,12,12,24
14,SEP,2013,LOCAL FLIGHTS,13,13,26
15,SEP,2013,LOCAL FLIGHTS,4,4,8
16,SEP,2013,LOCAL FLIGHTS,12,12,24
17,SEP,2013,LOCAL FLIGHTS,6,6,12
18,SEP,2013,LOCAL FLIGHTS,6,6,12
19,SEP,2013,LOCAL FLIGHTS,10,10,20
20,SEP,2013,LOCAL FLIGHTS,15,15,30
21,SEP,2013,LOCAL FLIGHTS,13,12,25
22,SEP,2013,LOCAL FLIGHTS,2,2,4
23,SEP,2013,LOCAL FLIGHTS,8,8,16
24,SEP,2013,LOCAL FLIGHTS,5,5,10
25,SEP,2013,LOCAL FLIGHTS,7,7,14
26,SEP,2013,LOCAL FLIGHTS,17,18,35
27,SEP,2013,LOCAL FLIGHTS,10,10,20
28,SEP,2013,LOCAL FLIGHTS,18,17,35
29,SEP,2013,LOCAL FLIGHTS,5,5,10
30,SEP,2013,LOCAL FLIGHTS,8,9,17
1,SEP,2013,HELICOPTER FLIGHTS,1,1,2
2,SEP,2013,HELICOPTER FLIGHTS,2,2,4
3,SEP,2013,HELICOPTER FLIGHTS,2,2,4
4,SEP,2013,HELICOPTER FLIGHTS,2,2,4
5,SEP,2013,HELICOPTER FLIGHTS,1,1,2
6,SEP,2013,HELICOPTER FLIGHTS,3,3,6
7,SEP,2013,HELICOPTER FLIGHTS,2,2,4
8,SEP,2013,HELICOPTER FLIGHTS,2,2,4
9,SEP,2013,HELICOPTER FLIGHTS,4,4,8
10,SEP,2013,HELICOPTER FLIGHTS,5,6,11
11,SEP,2013,HELICOPTER FLIGHTS,2,1,3
12,SEP,2013,HELICOPTER FLIGHTS,1,1,2
13,SEP,2013,HELICOPTER FLIGHTS,2,2,4
14,SEP,2013,HELICOPTER FLIGHTS,1,1,2
15,SEP,2013,HELICOPTER FLIGHTS,3,3,6
16,SEP,2013,HELICOPTER FLIGHTS,2,2,4
17,SEP,2013,HELICOPTER FLIGHTS,2,2,4
18,SEP,2013,HELICOPTER FLIGHTS,1,1,2
19,SEP,2013,HELICOPTER FLIGHTS,0,0,0
20,SEP,2013,HELICOPTER FLIGHTS,1,1,2
21,SEP,2013,HELICOPTER FLIGHTS,1,1,2
22,SEP,2013,HELICOPTER FLIGHTS,1,1,2
23,SEP,2013,HELICOPTER FLIGHTS,2,2,4
24,SEP,2013,HELICOPTER FLIGHTS,2,2,4
25,SEP,2013,HELICOPTER FLIGHTS,1,1,2
26,SEP,2013,HELICOPTER FLIGHTS,2,2,4
27,SEP,2013,HELICOPTER FLIGHTS,1,1,2
28,SEP,2013,HELICOPTER FLIGHTS,2,2,4
29,SEP,2013,HELICOPTER FLIGHTS,1,1,2
30,SEP,2013,HELICOPTER FLIGHTS,1,1,2
1,OCT,2013,INTERNATIONAL FLIGHTS,49,48,97
2,OCT,2013,INTERNATIONAL FLIGHTS,78,78,156
3,OCT,2013,INTERNATIONAL FLIGHTS,61,57,118
4,OCT,2013,INTERNATIONAL FLIGHTS,74,76,150
5,OCT,2013,INTERNATIONAL FLIGHTS,66,66,132
6,OCT,2013,INTERNATIONAL FLIGHTS,88,93,181
7,OCT,2013,INTERNATIONAL FLIGHTS,71,78,149
8,OCT,2013,INTERNATIONAL FLIGHTS,50,46,96
9,OCT,2013,INTERNATIONAL FLIGHTS,74,73,147
10,OCT,2013,INTERNATIONAL FLIGHTS,53,57,110
11,OCT,2013,INTERNATIONAL FLIGHTS,72,72,144
12,OCT,2013,INTERNATIONAL FLIGHTS,70,67,137
13,OCT,2013,INTERNATIONAL FLIGHTS,86,79,165
14,OCT,2013,INTERNATIONAL FLIGHTS,75,84,159
15,OCT,2013,INTERNATIONAL FLIGHTS,47,52,99
16,OCT,2013,INTERNATIONAL FLIGHTS,68,69,137
17,OCT,2013,INTERNATIONAL FLIGHTS,54,56,110
18,OCT,2013,INTERNATIONAL FLIGHTS,68,67,135
19,OCT,2013,INTERNATIONAL FLIGHTS,81,81,162
20,OCT,2013,INTERNATIONAL FLIGHTS,80,79,159
21,OCT,2013,INTERNATIONAL FLIGHTS,60,63,123
22,OCT,2013,INTERNATIONAL FLIGHTS,48,46,94
23,OCT,2013,INTERNATIONAL FLIGHTS,74,72,146
24,OCT,2013,INTERNATIONAL FLIGHTS,50,55,105
25,OCT,2013,INTERNATIONAL FLIGHTS,64,64,128
26,OCT,2013,INTERNATIONAL FLIGHTS,60,63,123
27,OCT,2013,INTERNATIONAL FLIGHTS,66,65,131
28,OCT,2013,INTERNATIONAL FLIGHTS,49,55,104
29,OCT,2013,INTERNATIONAL FLIGHTS,36,32,68
30,OCT,2013,INTERNATIONAL FLIGHTS,66,64,130
31,OCT,2013,INTERNATIONAL FLIGHTS,38,39,77
1,OCT,2013,LOCAL FLIGHTS,14,14,28
2,OCT,2013,LOCAL FLIGHTS,8,8,16
3,OCT,2013,LOCAL FLIGHTS,9,9,18
4,OCT,2013,LOCAL FLIGHTS,6,6,12
5,OCT,2013,LOCAL FLIGHTS,16,16,32
6,OCT,2013,LOCAL FLIGHTS,3,3,6
7,OCT,2013,LOCAL FLIGHTS,6,6,12
8,OCT,2013,LOCAL FLIGHTS,11,11,22
9,OCT,2013,LOCAL FLIGHTS,8,8,16
10,OCT,2013,LOCAL FLIGHTS,13,13,26
11,OCT,2013,LOCAL FLIGHTS,15,15,30
12,OCT,2013,LOCAL FLIGHTS,14,14,28
13,OCT,2013,LOCAL FLIGHTS,4,4,8
14,OCT,2013,LOCAL FLIGHTS,9,9,18
15,OCT,2013,LOCAL FLIGHTS,12,12,24
16,OCT,2013,LOCAL FLIGHTS,8,8,16
17,OCT,2013,LOCAL FLIGHTS,8,8,16
18,OCT,2013,LOCAL FLIGHTS,4,4,8
19,OCT,2013,LOCAL FLIGHTS,9,9,18
20,OCT,2013,LOCAL FLIGHTS,5,5,10
21,OCT,2013,LOCAL FLIGHTS,10,10,20
22,OCT,2013,LOCAL FLIGHTS,13,13,26
23,OCT,2013,LOCAL FLIGHTS,13,13,26
24,OCT,2013,LOCAL FLIGHTS,7,7,14
25,OCT,2013,LOCAL FLIGHTS,10,10,20
26,OCT,2013,LOCAL FLIGHTS,14,14,28
27,OCT,2013,LOCAL FLIGHTS,3,3,6
28,OCT,2013,LOCAL FLIGHTS,9,9,18
29,OCT,2013,LOCAL FLIGHTS,15,15,30
30,OCT,2013,LOCAL FLIGHTS,15,15,30
31,OCT,2013,LOCAL FLIGHTS,9,9,18
1,OCT,2013,HELICOPTER FLIGHTS,1,1,2
2,OCT,2013,HELICOPTER FLIGHTS,1,1,2
3,OCT,2013,HELICOPTER FLIGHTS,1,1,2
4,OCT,2013,HELICOPTER FLIGHTS,0,0,0
5,OCT,2013,HELICOPTER FLIGHTS,0,0,0
6,OCT,2013,HELICOPTER FLIGHTS,0,0,0
7,OCT,2013,HELICOPTER FLIGHTS,0,0,0
8,OCT,2013,HELICOPTER FLIGHTS,0,0,0
9,OCT,2013,HELICOPTER FLIGHTS,1,0,1
10,OCT,2013,HELICOPTER FLIGHTS,1,1,2
11,OCT,2013,HELICOPTER FLIGHTS,0,0,0
12,OCT,2013,HELICOPTER FLIGHTS,1,1,2
13,OCT,2013,HELICOPTER FLIGHTS,2,2,4
14,OCT,2013,HELICOPTER FLIGHTS,0,0,0
15,OCT,2013,HELICOPTER FLIGHTS,0,0,0
16,OCT,2013,HELICOPTER FLIGHTS,0,0,0
17,OCT,2013,HELICOPTER FLIGHTS,0,0,0
18,OCT,2013,HELICOPTER FLIGHTS,3,3,6
19,OCT,2013,HELICOPTER FLIGHTS,0,0,0
20,OCT,2013,HELICOPTER FLIGHTS,0,0,0
21,OCT,2013,HELICOPTER FLIGHTS,0,0,0
22,OCT,2013,HELICOPTER FLIGHTS,1,1,2
23,OCT,2013,HELICOPTER FLIGHTS,2,2,4
24,OCT,2013,HELICOPTER FLIGHTS,3,3,6
25,OCT,2013,HELICOPTER FLIGHTS,0,0,0
26,OCT,2013,HELICOPTER FLIGHTS,0,0,0
27,OCT,2013,HELICOPTER FLIGHTS,0,0,0
28,OCT,2013,HELICOPTER FLIGHTS,0,0,0
29,OCT,2013,HELICOPTER FLIGHTS,1,1,2
30,OCT,2013,HELICOPTER FLIGHTS,1,1,2
31,OCT,2013,HELICOPTER FLIGHTS,1,1,2
1,NOV,2013,INTERNATIONAL FLIGHTS,42,43,85
2,NOV,2013,INTERNATIONAL FLIGHTS,57,60,117
3,NOV,2013,INTERNATIONAL FLIGHTS,57,51,108
4,NOV,2013,INTERNATIONAL FLIGHTS,45,49,94
5,NOV,2013,INTERNATIONAL FLIGHTS,34,34,68
6,NOV,2013,INTERNATIONAL FLIGHTS,55,57,112
7,NOV,2013,INTERNATIONAL FLIGHTS,44,30,74
8,NOV,2013,INTERNATIONAL FLIGHTS,39,43,82
9,NOV,2013,INTERNATIONAL FLIGHTS,46,46,92
10,NOV,2013,INTERNATIONAL FLIGHTS,42,44,86
11,NOV,2013,INTERNATIONAL FLIGHTS,46,48,94
12,NOV,2013,INTERNATIONAL FLIGHTS,30,33,63
13,NOV,2013,INTERNATIONAL FLIGHTS,46,46,92
14,NOV,2013,INTERNATIONAL FLIGHTS,39,35,74
15,NOV,2013,INTERNATIONAL FLIGHTS,33,39,72
16,NOV,2013,INTERNATIONAL FLIGHTS,46,43,89
17,NOV,2013,INTERNATIONAL FLIGHTS,39,39,78
18,NOV,2013,INTERNATIONAL FLIGHTS,38,40,78
19,NOV,2013,INTERNATIONAL FLIGHTS,33,30,63
20,NOV,2013,INTERNATIONAL FLIGHTS,46,47,93
21,NOV,2013,INTERNATIONAL FLIGHTS,30,26,56
22,NOV,2013,INTERNATIONAL FLIGHTS,37,32,69
23,NOV,2013,INTERNATIONAL FLIGHTS,42,43,85
24,NOV,2013,INTERNATIONAL FLIGHTS,31,31,62
25,NOV,2013,INTERNATIONAL FLIGHTS,42,39,81
26,NOV,2013,INTERNATIONAL FLIGHTS,29,33,62
27,NOV,2013,INTERNATIONAL FLIGHTS,56,48,104
28,NOV,2013,INTERNATIONAL FLIGHTS,41,37,78
29,NOV,2013,INTERNATIONAL FLIGHTS,41,52,93
30,NOV,2013,INTERNATIONAL FLIGHTS,42,42,84
1,NOV,2013,LOCAL FLIGHTS,10,10,20
2,NOV,2013,LOCAL FLIGHTS,11,11,22
3,NOV,2013,LOCAL FLIGHTS,7,7,14
4,NOV,2013,LOCAL FLIGHTS,12,12,24
5,NOV,2013,LOCAL FLIGHTS,12,12,24
6,NOV,2013,LOCAL FLIGHTS,13,13,26
7,NOV,2013,LOCAL FLIGHTS,7,7,14
8,NOV,2013,LOCAL FLIGHTS,12,12,24
9,NOV,2013,LOCAL FLIGHTS,12,13,25
10,NOV,2013,LOCAL FLIGHTS,12,12,24
11,NOV,2013,LOCAL FLIGHTS,5,5,10
12,NOV,2013,LOCAL FLIGHTS,14,13,27
13,NOV,2013,LOCAL FLIGHTS,6,6,12
14,NOV,2013,LOCAL FLIGHTS,9,9,18
15,NOV,2013,LOCAL FLIGHTS,12,12,24
16,NOV,2013,LOCAL FLIGHTS,15,15,30
17,NOV,2013,LOCAL FLIGHTS,0,0,0
18,NOV,2013,LOCAL FLIGHTS,2,2,4
19,NOV,2013,LOCAL FLIGHTS,5,5,10
20,NOV,2013,LOCAL FLIGHTS,9,9,18
21,NOV,2013,LOCAL FLIGHTS,11,11,22
22,NOV,2013,LOCAL FLIGHTS,8,8,16
23,NOV,2013,LOCAL FLIGHTS,9,9,18
24,NOV,2013,LOCAL FLIGHTS,6,6,12
25,NOV,2013,LOCAL FLIGHTS,6,6,12
26,NOV,2013,LOCAL FLIGHTS,3,3,6
27,NOV,2013,LOCAL FLIGHTS,13,11,24
28,NOV,2013,LOCAL FLIGHTS,10,10,20
29,NOV,2013,LOCAL FLIGHTS,11,15,26
30,NOV,2013,LOCAL FLIGHTS,17,17,34
1,NOV,2013,HELICOPTER FLIGHTS,1,1,2
2,NOV,2013,HELICOPTER FLIGHTS,0,0,0
3,NOV,2013,HELICOPTER FLIGHTS,0,0,0
4,NOV,2013,HELICOPTER FLIGHTS,1,1,2
5,NOV,2013,HELICOPTER FLIGHTS,0,0,0
6,NOV,2013,HELICOPTER FLIGHTS,2,2,4
7,NOV,2013,HELICOPTER FLIGHTS,0,0,0
8,NOV,2013,HELICOPTER FLIGHTS,1,1,2
9,NOV,2013,HELICOPTER FLIGHTS,0,0,0
10,NOV,2013,HELICOPTER FLIGHTS,0,0,0
11,NOV,2013,HELICOPTER FLIGHTS,0,0,0
12,NOV,2013,HELICOPTER FLIGHTS,0,0,0
13,NOV,2013,HELICOPTER FLIGHTS,0,0,0
14,NOV,2013,HELICOPTER FLIGHTS,1,1,2
15,NOV,2013,HELICOPTER FLIGHTS,0,0,0
16,NOV,2013,HELICOPTER FLIGHTS,0,0,0
17,NOV,2013,HELICOPTER FLIGHTS,0,0,0
18,NOV,2013,HELICOPTER FLIGHTS,1,1,2
19,NOV,2013,HELICOPTER FLIGHTS,0,0,0
20,NOV,2013,HELICOPTER FLIGHTS,0,0,0
21,NOV,2013,HELICOPTER FLIGHTS,1,1,2
22,NOV,2013,HELICOPTER FLIGHTS,0,0,0
23,NOV,2013,HELICOPTER FLIGHTS,2,2,4
24,NOV,2013,HELICOPTER FLIGHTS,0,0,0
25,NOV,2013,HELICOPTER FLIGHTS,1,1,2
26,NOV,2013,HELICOPTER FLIGHTS,0,0,0
27,NOV,2013,HELICOPTER FLIGHTS,2,2,4
28,NOV,2013,HELICOPTER FLIGHTS,1,1,2
29,NOV,2013,HELICOPTER FLIGHTS,1,1,2
30,NOV,2013,HELICOPTER FLIGHTS,0,0,0
1,DEC,2013,INTERNATIONAL FLIGHTS,38,37,75
2,DEC,2013,INTERNATIONAL FLIGHTS,34,34,68
3,DEC,2013,INTERNATIONAL FLIGHTS,25,26,51
4,DEC,2013,INTERNATIONAL FLIGHTS,41,4,45
5,DEC,2013,INTERNATIONAL FLIGHTS,28,28,56
6,DEC,2013,INTERNATIONAL FLIGHTS,35,34,69
7,DEC,2013,INTERNATIONAL FLIGHTS,39,42,81
8,DEC,2013,INTERNATIONAL FLIGHTS,47,40,87
9,DEC,2013,INTERNATIONAL FLIGHTS,32,32,64
10,DEC,2013,INTERNATIONAL FLIGHTS,33,32,65
11,DEC,2013,INTERNATIONAL FLIGHTS,43,44,87
12,DEC,2013,INTERNATIONAL FLIGHTS,29,31,60
13,DEC,2013,INTERNATIONAL FLIGHTS,39,41,80
14,DEC,2013,INTERNATIONAL FLIGHTS,41,44,85
15,DEC,2013,INTERNATIONAL FLIGHTS,41,40,81
16,DEC,2013,INTERNATIONAL FLIGHTS,34,30,64
17,DEC,2013,INTERNATIONAL FLIGHTS,42,34,76
18,DEC,2013,INTERNATIONAL FLIGHTS,40,44,84
19,DEC,2013,INTERNATIONAL FLIGHTS,31,33,64
20,DEC,2013,INTERNATIONAL FLIGHTS,36,35,71
21,DEC,2013,INTERNATIONAL FLIGHTS,53,51,104
22,DEC,2013,INTERNATIONAL FLIGHTS,42,37,79
23,DEC,2013,INTERNATIONAL FLIGHTS,30,35,65
24,DEC,2013,INTERNATIONAL FLIGHTS,29,25,54
25,DEC,2013,INTERNATIONAL FLIGHTS,26,29,55
26,DEC,2013,INTERNATIONAL FLIGHTS,28,29,57
27,DEC,2013,INTERNATIONAL FLIGHTS,35,32,67
28,DEC,2013,INTERNATIONAL FLIGHTS,45,48,93
29,DEC,2013,INTERNATIONAL FLIGHTS,33,36,69
30,DEC,2013,INTERNATIONAL FLIGHTS,27,26,53
31,DEC,2013,INTERNATIONAL FLIGHTS,26,26,52
1,DEC,2013,LOCAL FLIGHTS,8,8,16
2,DEC,2013,LOCAL FLIGHTS,10,10,20
3,DEC,2013,LOCAL FLIGHTS,10,10,20
4,DEC,2013,LOCAL FLIGHTS,2,2,4
5,DEC,2013,LOCAL FLIGHTS,12,12,24
6,DEC,2013,LOCAL FLIGHTS,13,13,26
7,DEC,2013,LOCAL FLIGHTS,15,16,31
8,DEC,2013,LOCAL FLIGHTS,2,2,4
9,DEC,2013,LOCAL FLIGHTS,3,3,6
10,DEC,2013,LOCAL FLIGHTS,4,3,7
11,DEC,2013,LOCAL FLIGHTS,0,0,0
12,DEC,2013,LOCAL FLIGHTS,1,1,2
13,DEC,2013,LOCAL FLIGHTS,0,0,0
14,DEC,2013,LOCAL FLIGHTS,4,4,8
15,DEC,2013,LOCAL FLIGHTS,11,11,22
16,DEC,2013,LOCAL FLIGHTS,7,7,14
17,DEC,2013,LOCAL FLIGHTS,6,6,12
18,DEC,2013,LOCAL FLIGHTS,11,10,21
19,DEC,2013,LOCAL FLIGHTS,7,6,13
20,DEC,2013,LOCAL FLIGHTS,9,9,18
21,DEC,2013,LOCAL FLIGHTS,7,7,14
22,DEC,2013,LOCAL FLIGHTS,9,9,18
23,DEC,2013,LOCAL FLIGHTS,11,10,21
24,DEC,2013,LOCAL FLIGHTS,5,5,10
25,DEC,2013,LOCAL FLIGHTS,1,1,2
26,DEC,2013,LOCAL FLIGHTS,2,2,4
27,DEC,2013,LOCAL FLIGHTS,10,10,20
28,DEC,2013,LOCAL FLIGHTS,7,7,14
29,DEC,2013,LOCAL FLIGHTS,0,0,0
30,DEC,2013,LOCAL FLIGHTS,4,4,8
31,DEC,2013,LOCAL FLIGHTS,0,6,6
1,DEC,2013,HELICOPTER FLIGHTS,2,2,4
2,DEC,2013,HELICOPTER FLIGHTS,1,1,2
3,DEC,2013,HELICOPTER FLIGHTS,2,2,4
4,DEC,2013,HELICOPTER FLIGHTS,1,1,2
5,DEC,2013,HELICOPTER FLIGHTS,1,1,2
6,DEC,2013,HELICOPTER FLIGHTS,2,1,3
7,DEC,2013,HELICOPTER FLIGHTS,1,1,2
8,DEC,2013,HELICOPTER FLIGHTS,1,1,2
9,DEC,2013,HELICOPTER FLIGHTS,1,0,1
10,DEC,2013,HELICOPTER FLIGHTS,2,2,4
11,DEC,2013,HELICOPTER FLIGHTS,1,1,2
12,DEC,2013,HELICOPTER FLIGHTS,1,1,2
13,DEC,2013,HELICOPTER FLIGHTS,1,1,2
14,DEC,2013,HELICOPTER FLIGHTS,3,3,6
15,DEC,2013,HELICOPTER FLIGHTS,0,0,0
16,DEC,2013,HELICOPTER FLIGHTS,1,1,2
17,DEC,2013,HELICOPTER FLIGHTS,1,1,2
18,DEC,2013,HELICOPTER FLIGHTS,1,1,2
19,DEC,2013,HELICOPTER FLIGHTS,2,2,4
20,DEC,2013,HELICOPTER FLIGHTS,0,0,0
21,DEC,2013,HELICOPTER FLIGHTS,1,2,3
22,DEC,2013,HELICOPTER FLIGHTS,0,0,0
23,DEC,2013,HELICOPTER FLIGHTS,1,1,2
24,DEC,2013,HELICOPTER FLIGHTS,0,0,0
25,DEC,2013,HELICOPTER FLIGHTS,0,0,0
26,DEC,2013,HELICOPTER FLIGHTS,0,0,0
27,DEC,2013,HELICOPTER FLIGHTS,0,0,0
28,DEC,2013,HELICOPTER FLIGHTS,1,1,2
29,DEC,2013,HELICOPTER FLIGHTS,0,0,0
30,DEC,2013,HELICOPTER FLIGHTS,0,0,0
31,DEC,2013,HELICOPTER FLIGHTS,2,2,4
