DAY,MONTH,YEAR,FLIGHT_CATEGORY,INBOUND_FLIGHTS,OUTBOUND_FLIGHTS,TOTAL_FLIGHTS
1,JAN,2014,INTERNATIONAL FLIGHTS,37,36,73
2,JAN,2014,INTERNATIONAL FLIGHTS,27,28,55
3,JAN,2014,INTERNATIONAL FLIGHTS,36,34,70
4,JAN,2014,INTERNATIONAL FLIGHTS,45,47,92
5,JAN,2014,INTERNATIONAL FLIGHTS,37,38,75
6,JAN,2014,INTERNATIONAL FLIGHTS,38,39,77
7,JAN,2014,INTERNATIONAL FLIGHTS,32,30,62
8,JAN,2014,INTERNATIONAL FLIGHTS,39,44,83
9,JAN,2014,INTERNATIONAL FLIGHTS,25,27,52
10,JAN,2014,INTERNATIONAL FLIGHTS,35,33,68
11,JAN,2014,INTERNATIONAL FLIGHTS,42,46,88
12,JAN,2014,INTERNATIONAL FLIGHTS,32,35,67
13,JAN,2014,INTERNATIONAL FLIGHTS,31,32,63
14,JAN,2014,INTERNATIONAL FLIGHTS,26,29,55
15,JAN,2014,INTERNATIONAL FLIGHTS,44,43,87
16,JAN,2014,INTERNATIONAL FLIGHTS,29,28,57
17,JAN,2014,INTERNATIONAL FLIGHTS,33,35,68
18,JAN,2014,INTERNATIONAL FLIGHTS,39,39,78
19,JAN,2014,INTERNATIONAL FLIGHTS,34,36,70
20,JAN,2014,INTERNATIONAL FLIGHTS,35,61,96
21,JAN,2014,INTERNATIONAL FLIGHTS,33,23,56
22,JAN,2014,INTERNATIONAL FLIGHTS,41,44,85
23,JAN,2014,INTERNATIONAL FLIGHTS,24,27,51
24,JAN,2014,INTERNATIONAL FLIGHTS,30,31,61
25,JAN,2014,INTERNATIONAL FLIGHTS,39,39,78
26,JAN,2014,INTERNATIONAL FLIGHTS,36,35,71
27,JAN,2014,INTERNATIONAL FLIGHTS,35,33,68
28,JAN,2014,INTERNATIONAL FLIGHTS,26,28,54
29,JAN,2014,INTERNATIONAL FLIGHTS,40,37,77
30,JAN,2014,INTERNATIONAL FLIGHTS,32,29,61
31,JAN,2014,INTERNATIONAL FLIGHTS,35,36,71
1,JAN,2014,LOCAL FLIGHTS,0,0,0
2,JAN,2014,LOCAL FLIGHTS,6,6,12
3,JAN,2014,LOCAL FLIGHTS,5,5,10
4,JAN,2014,LOCAL FLIGHTS,6,6,12
5,JAN,2014,LOCAL FLIGHTS,2,2,4
6,JAN,2014,LOCAL FLIGHTS,5,5,10
7,JAN,2014,LOCAL FLIGHTS,6,6,12
8,JAN,2014,LOCAL FLIGHTS,7,7,14
9,JAN,2014,LOCAL FLIGHTS,9,9,18
10,JAN,2014,LOCAL FLIGHTS,10,10,20
11,JAN,2014,LOCAL FLIGHTS,17,17,34
12,JAN,2014,LOCAL FLIGHTS,3,3,6
13,JAN,2014,LOCAL FLIGHTS,4,4,8
14,JAN,2014,LOCAL FLIGHTS,9,9,18
15,JAN,2014,LOCAL FLIGHTS,6,5,11
16,JAN,2014,LOCAL FLIGHTS,5,5,10
17,JAN,2014,LOCAL FLIGHTS,7,7,14
18,JAN,2014,LOCAL FLIGHTS,15,15,30
19,JAN,2014,LOCAL FLIGHTS,7,7,14
20,JAN,2014,LOCAL FLIGHTS,11,17,28
21,JAN,2014,LOCAL FLIGHTS,8,9,17
22,JAN,2014,LOCAL FLIGHTS,11,11,22
23,JAN,2014,LOCAL FLIGHTS,8,8,16
24,JAN,2014,LOCAL FLIGHTS,8,8,16
25,JAN,2014,LOCAL FLIGHTS,5,5,10
26,JAN,2014,LOCAL FLIGHTS,0,0,0
27,JAN,2014,LOCAL FLIGHTS,1,1,2
28,JAN,2014,LOCAL FLIGHTS,4,4,8
29,JAN,2014,LOCAL FLIGHTS,5,5,10
30,JAN,2014,LOCAL FLIGHTS,16,15,31
31,JAN,2014,LOCAL FLIGHTS,8,8,16
1,JAN,2014,HELICOPTER FLIGHTS,0,0,0
2,JAN,2014,HELICOPTER FLIGHTS,2,2,4
3,JAN,2014,HELICOPTER FLIGHTS,2,2,4
4,JAN,2014,HELICOPTER FLIGHTS,2,2,4
5,JAN,2014,HELICOPTER FLIGHTS,0,0,0
6,JAN,2014,HELICOPTER FLIGHTS,1,1,2
7,JAN,2014,HELICOPTER FLIGHTS,2,2,4
8,JAN,2014,HELICOPTER FLIGHTS,1,1,2
9,JAN,2014,HELICOPTER FLIGHTS,3,3,6
10,JAN,2014,HELICOPTER FLIGHTS,2,2,4
11,JAN,2014,HELICOPTER FLIGHTS,5,5,10
12,JAN,2014,HELICOPTER FLIGHTS,0,0,0
13,JAN,2014,HELICOPTER FLIGHTS,2,2,4
14,JAN,2014,HELICOPTER FLIGHTS,3,3,6
15,JAN,2014,HELICOPTER FLIGHTS,2,2,4
16,JAN,2014,HELICOPTER FLIGHTS,1,1,2
17,JAN,2014,HELICOPTER FLIGHTS,2,2,4
18,JAN,2014,HELICOPTER FLIGHTS,2,2,4
19,JAN,2014,HELICOPTER FLIGHTS,0,0,0
20,JAN,2014,HELICOPTER FLIGHTS,2,2,4
21,JAN,2014,HELICOPTER FLIGHTS,4,4,8
22,JAN,2014,HELICOPTER FLIGHTS,1,1,2
23,JAN,2014,HELICOPTER FLIGHTS,1,1,2
24,JAN,2014,HELICOPTER FLIGHTS,2,2,4
25,JAN,2014,HELICOPTER FLIGHTS,4,4,8
26,JAN,2014,HELICOPTER FLIGHTS,0,0,0
27,JAN,2014,HELICOPTER FLIGHTS,1,1,2
28,JAN,2014,HELICOPTER FLIGHTS,2,2,4
29,JAN,2014,HELICOPTER FLIGHTS,2,2,4
30,JAN,2014,HELICOPTER FLIGHTS,2,2,4
31,JAN,2014,HELICOPTER FLIGHTS,2,2,4
1,FEB,2014,INTERNATIONAL FLIGHTS,40,42,82
2,FEB,2014,INTERNATIONAL FLIGHTS,33,36,69
3,FEB,2014,INTERNATIONAL FLIGHTS,33,32,65
4,FEB,2014,INTERNATIONAL FLIGHTS,27,28,55
5,FEB,2014,INTERNATIONAL FLIGHTS,39,41,80
6,FEB,2014,INTERNATIONAL FLIGHTS,23,25,48
7,FEB,2014,INTERNATIONAL FLIGHTS,33,32,65
8,FEB,2014,INTERNATIONAL FLIGHTS,36,38,74
9,FEB,2014,INTERNATIONAL FLIGHTS,34,36,70
10,FEB,2014,INTERNATIONAL FLIGHTS,35,31,66
11,FEB,2014,INTERNATIONAL FLIGHTS,24,26,50
12,FEB,2014,INTERNATIONAL FLIGHTS,43,40,83
13,FEB,2014,INTERNATIONAL FLIGHTS,30,32,62
14,FEB,2014,INTERNATIONAL FLIGHTS,37,40,77
15,FEB,2014,INTERNATIONAL FLIGHTS,42,40,82
16,FEB,2014,INTERNATIONAL FLIGHTS,33,35,68
17,FEB,2014,INTERNATIONAL FLIGHTS,33,33,66
18,FEB,2014,INTERNATIONAL FLIGHTS,29,29,58
19,FEB,2014,INTERNATIONAL FLIGHTS,43,41,84
20,FEB,2014,INTERNATIONAL FLIGHTS,39,37,76
21,FEB,2014,INTERNATIONAL FLIGHTS,35,33,68
22,FEB,2014,INTERNATIONAL FLIGHTS,39,44,83
23,FEB,2014,INTERNATIONAL FLIGHTS,36,39,75
24,FEB,2014,INTERNATIONAL FLIGHTS,32,31,63
25,FEB,2014,INTERNATIONAL FLIGHTS,29,27,56
26,FEB,2014,INTERNATIONAL FLIGHTS,39,40,79
27,FEB,2014,INTERNATIONAL FLIGHTS,30,32,62
28,FEB,2014,INTERNATIONAL FLIGHTS,37,39,76
1,FEB,2014,LOCAL FLIGHTS,16,16,32
2,FEB,2014,LOCAL FLIGHTS,2,2,4
3,FEB,2014,LOCAL FLIGHTS,2,2,4
4,FEB,2014,LOCAL FLIGHTS,11,11,22
5,FEB,2014,LOCAL FLIGHTS,9,9,18
6,FEB,2014,LOCAL FLIGHTS,4,4,8
7,FEB,2014,LOCAL FLIGHTS,8,8,16
8,FEB,2014,LOCAL FLIGHTS,12,12,24
9,FEB,2014,LOCAL FLIGHTS,6,6,12
10,FEB,2014,LOCAL FLIGHTS,3,3,6
11,FEB,2014,LOCAL FLIGHTS,4,5,9
12,FEB,2014,LOCAL FLIGHTS,7,7,14
13,FEB,2014,LOCAL FLIGHTS,4,4,8
14,FEB,2014,LOCAL FLIGHTS,3,3,6
15,FEB,2014,LOCAL FLIGHTS,8,8,16
16,FEB,2014,LOCAL FLIGHTS,4,4,8
17,FEB,2014,LOCAL FLIGHTS,10,11,21
18,FEB,2014,LOCAL FLIGHTS,8,8,16
19,FEB,2014,LOCAL FLIGHTS,13,12,25
20,FEB,2014,LOCAL FLIGHTS,6,6,12
21,FEB,2014,LOCAL FLIGHTS,12,12,24
22,FEB,2014,LOCAL FLIGHTS,13,13,26
23,FEB,2014,LOCAL FLIGHTS,3,3,6
24,FEB,2014,LOCAL FLIGHTS,1,1,2
25,FEB,2014,LOCAL FLIGHTS,1,1,2
26,FEB,2014,LOCAL FLIGHTS,5,5,10
27,FEB,2014,LOCAL FLIGHTS,4,4,8
28,FEB,2014,LOCAL FLIGHTS,8,7,15
1,FEB,2014,HELICOPTER FLIGHTS,2,2,4
2,FEB,2014,HELICOPTER FLIGHTS,0,0,0
3,FEB,2014,HELICOPTER FLIGHTS,2,2,4
4,FEB,2014,HELICOPTER FLIGHTS,2,2,4
5,FEB,2014,HELICOPTER FLIGHTS,1,1,2
6,FEB,2014,HELICOPTER FLIGHTS,3,3,6
7,FEB,2014,HELICOPTER FLIGHTS,2,2,4
8,FEB,2014,HELICOPTER FLIGHTS,1,1,2
9,FEB,2014,HELICOPTER FLIGHTS,0,0,0
10,FEB,2014,HELICOPTER FLIGHTS,1,1,2
11,FEB,2014,HELICOPTER FLIGHTS,1,1,2
12,FEB,2014,HELICOPTER FLIGHTS,1,1,2
13,FEB,2014,HELICOPTER FLIGHTS,3,3,6
14,FEB,2014,HELICOPTER FLIGHTS,1,1,2
15,FEB,2014,HELICOPTER FLIGHTS,2,2,4
16,FEB,2014,HELICOPTER FLIGHTS,0,0,0
17,FEB,2014,HELICOPTER FLIGHTS,2,2,4
18,FEB,2014,HELICOPTER FLIGHTS,2,2,4
19,FEB,2014,HELICOPTER FLIGHTS,2,2,4
20,FEB,2014,HELICOPTER FLIGHTS,2,2,4
21,FEB,2014,HELICOPTER FLIGHTS,2,2,4
22,FEB,2014,HELICOPTER FLIGHTS,2,2,4
23,FEB,2014,HELICOPTER FLIGHTS,0,0,0
24,FEB,2014,HELICOPTER FLIGHTS,2,2,4
25,FEB,2014,HELICOPTER FLIGHTS,1,1,2
26,FEB,2014,HELICOPTER FLIGHTS,3,3,6
27,FEB,2014,HELICOPTER FLIGHTS,1,1,2
28,FEB,2014,HELICOPTER FLIGHTS,1,3,4
1,MAR,2014,INTERNATIONAL FLIGHTS,42,46,88
2,MAR,2014,INTERNATIONAL FLIGHTS,34,34,68
3,MAR,2014,INTERNATIONAL FLIGHTS,35,37,72
4,MAR,2014,INTERNATIONAL FLIGHTS,35,28,63
5,MAR,2014,INTERNATIONAL FLIGHTS,43,53,96
6,MAR,2014,INTERNATIONAL FLIGHTS,27,31,58
7,MAR,2014,INTERNATIONAL FLIGHTS,44,37,81
8,MAR,2014,INTERNATIONAL FLIGHTS,47,51,98
9,MAR,2014,INTERNATIONAL FLIGHTS,34,39,73
10,MAR,2014,INTERNATIONAL FLIGHTS,38,38,76
11,MAR,2014,INTERNATIONAL FLIGHTS,29,28,57
12,MAR,2014,INTERNATIONAL FLIGHTS,48,51,99
13,MAR,2014,INTERNATIONAL FLIGHTS,32,33,65
14,MAR,2014,INTERNATIONAL FLIGHTS,38,37,75
15,MAR,2014,INTERNATIONAL FLIGHTS,42,42,84
16,MAR,2014,INTERNATIONAL FLIGHTS,34,38,72
17,MAR,2014,INTERNATIONAL FLIGHTS,36,33,69
18,MAR,2014,INTERNATIONAL FLIGHTS,31,29,60
19,MAR,2014,INTERNATIONAL FLIGHTS,46,46,92
20,MAR,2014,INTERNATIONAL FLIGHTS,39,30,69
21,MAR,2014,INTERNATIONAL FLIGHTS,60,46,106
22,MAR,2014,INTERNATIONAL FLIGHTS,49,64,113
23,MAR,2014,INTERNATIONAL FLIGHTS,37,48,85
24,MAR,2014,INTERNATIONAL FLIGHTS,34,36,70
25,MAR,2014,INTERNATIONAL FLIGHTS,29,24,53
26,MAR,2014,INTERNATIONAL FLIGHTS,47,45,92
27,MAR,2014,INTERNATIONAL FLIGHTS,35,39,74
28,MAR,2014,INTERNATIONAL FLIGHTS,46,41,87
29,MAR,2014,INTERNATIONAL FLIGHTS,41,43,84
30,MAR,2014,INTERNATIONAL FLIGHTS,47,50,97
31,MAR,2014,INTERNATIONAL FLIGHTS,35,39,74
1,MAR,2014,LOCAL FLIGHTS,11,11,22
2,MAR,2014,LOCAL FLIGHTS,0,0,0
3,MAR,2014,LOCAL FLIGHTS,1,1,2
4,MAR,2014,LOCAL FLIGHTS,6,6,12
5,MAR,2014,LOCAL FLIGHTS,5,5,10
6,MAR,2014,LOCAL FLIGHTS,3,3,6
7,MAR,2014,LOCAL FLIGHTS,7,7,14
8,MAR,2014,LOCAL FLIGHTS,13,13,26
9,MAR,2014,LOCAL FLIGHTS,4,4,8
10,MAR,2014,LOCAL FLIGHTS,3,3,6
11,MAR,2014,LOCAL FLIGHTS,2,2,4
12,MAR,2014,LOCAL FLIGHTS,6,6,12
13,MAR,2014,LOCAL FLIGHTS,2,2,4
14,MAR,2014,LOCAL FLIGHTS,7,7,14
15,MAR,2014,LOCAL FLIGHTS,18,18,36
16,MAR,2014,LOCAL FLIGHTS,2,2,4
17,MAR,2014,LOCAL FLIGHTS,2,2,4
18,MAR,2014,LOCAL FLIGHTS,6,6,12
19,MAR,2014,LOCAL FLIGHTS,10,10,20
20,MAR,2014,LOCAL FLIGHTS,9,9,18
21,MAR,2014,LOCAL FLIGHTS,9,9,18
22,MAR,2014,LOCAL FLIGHTS,18,18,36
23,MAR,2014,LOCAL FLIGHTS,6,6,12
24,MAR,2014,LOCAL FLIGHTS,10,10,20
25,MAR,2014,LOCAL FLIGHTS,3,3,6
26,MAR,2014,LOCAL FLIGHTS,6,6,12
27,MAR,2014,LOCAL FLIGHTS,12,12,24
28,MAR,2014,LOCAL FLIGHTS,8,8,16
29,MAR,2014,LOCAL FLIGHTS,11,15,26
30,MAR,2014,LOCAL FLIGHTS,3,3,6
31,MAR,2014,LOCAL FLIGHTS,10,10,20
1,MAR,2014,HELICOPTER FLIGHTS,1,1,2
2,MAR,2014,HELICOPTER FLIGHTS,1,1,2
3,MAR,2014,HELICOPTER FLIGHTS,1,1,2
4,MAR,2014,HELICOPTER FLIGHTS,2,2,4
5,MAR,2014,HELICOPTER FLIGHTS,2,2,4
6,MAR,2014,HELICOPTER FLIGHTS,0,0,0
7,MAR,2014,HELICOPTER FLIGHTS,0,0,0
8,MAR,2014,HELICOPTER FLIGHTS,0,0,0
9,MAR,2014,HELICOPTER FLIGHTS,0,0,0
10,MAR,2014,HELICOPTER FLIGHTS,0,0,0
11,MAR,2014,HELICOPTER FLIGHTS,0,0,0
12,MAR,2014,HELICOPTER FLIGHTS,0,0,0
13,MAR,2014,HELICOPTER FLIGHTS,0,0,0
14,MAR,2014,HELICOPTER FLIGHTS,0,2,2
15,MAR,2014,HELICOPTER FLIGHTS,2,2,4
16,MAR,2014,HELICOPTER FLIGHTS,1,1,2
17,MAR,2014,HELICOPTER FLIGHTS,1,1,2
18,MAR,2014,HELICOPTER FLIGHTS,1,1,2
19,MAR,2014,HELICOPTER FLIGHTS,0,0,0
20,MAR,2014,HELICOPTER FLIGHTS,0,0,0
21,MAR,2014,HELICOPTER FLIGHTS,1,1,2
22,MAR,2014,HELICOPTER FLIGHTS,0,0,0
23,MAR,2014,HELICOPTER FLIGHTS,0,0,0
24,MAR,2014,HELICOPTER FLIGHTS,0,0,0
25,MAR,2014,HELICOPTER FLIGHTS,0,0,0
26,MAR,2014,HELICOPTER FLIGHTS,1,1,2
27,MAR,2014,HELICOPTER FLIGHTS,2,2,4
28,MAR,2014,HELICOPTER FLIGHTS,2,1,3
29,MAR,2014,HELICOPTER FLIGHTS,0,0,0
30,MAR,2014,HELICOPTER FLIGHTS,0,0,0
31,MAR,2014,HELICOPTER FLIGHTS,1,1,2
1,APR,2014,INTERNATIONAL FLIGHTS,39,32,71
2,APR,2014,INTERNATIONAL FLIGHTS,54,52,106
3,APR,2014,INTERNATIONAL FLIGHTS,37,39,76
4,APR,2014,INTERNATIONAL FLIGHTS,52,55,107
5,APR,2014,INTERNATIONAL FLIGHTS,54,58,112
6,APR,2014,INTERNATIONAL FLIGHTS,48,49,97
7,APR,2014,INTERNATIONAL FLIGHTS,45,41,86
8,APR,2014,INTERNATIONAL FLIGHTS,36,38,74
9,APR,2014,INTERNATIONAL FLIGHTS,60,62,122
10,APR,2014,INTERNATIONAL FLIGHTS,41,41,82
11,APR,2014,INTERNATIONAL FLIGHTS,50,51,101
12,APR,2014,INTERNATIONAL FLIGHTS,52,56,108
13,APR,2014,INTERNATIONAL FLIGHTS,54,58,112
14,APR,2014,INTERNATIONAL FLIGHTS,47,46,93
15,APR,2014,INTERNATIONAL FLIGHTS,43,37,80
16,APR,2014,INTERNATIONAL FLIGHTS,63,62,125
17,APR,2014,INTERNATIONAL FLIGHTS,47,51,98
18,APR,2014,INTERNATIONAL FLIGHTS,54,54,108
19,APR,2014,INTERNATIONAL FLIGHTS,52,54,106
20,APR,2014,INTERNATIONAL FLIGHTS,52,51,103
21,APR,2014,INTERNATIONAL FLIGHTS,52,53,105
22,APR,2014,INTERNATIONAL FLIGHTS,50,41,91
23,APR,2014,INTERNATIONAL FLIGHTS,62,62,124
24,APR,2014,INTERNATIONAL FLIGHTS,42,43,85
25,APR,2014,INTERNATIONAL FLIGHTS,63,67,130
26,APR,2014,INTERNATIONAL FLIGHTS,61,61,122
27,APR,2014,INTERNATIONAL FLIGHTS,68,66,134
28,APR,2014,INTERNATIONAL FLIGHTS,66,63,129
29,APR,2014,INTERNATIONAL FLIGHTS,57,59,116
30,APR,2014,INTERNATIONAL FLIGHTS,73,72,145
1,APR,2014,LOCAL FLIGHTS,8,8,16
2,APR,2014,LOCAL FLIGHTS,13,12,25
3,APR,2014,LOCAL FLIGHTS,4,4,8
4,APR,2014,LOCAL FLIGHTS,15,15,30
5,APR,2014,LOCAL FLIGHTS,16,16,32
6,APR,2014,LOCAL FLIGHTS,4,4,8
7,APR,2014,LOCAL FLIGHTS,13,14,27
8,APR,2014,LOCAL FLIGHTS,3,5,8
9,APR,2014,LOCAL FLIGHTS,8,8,16
10,APR,2014,LOCAL FLIGHTS,7,7,14
11,APR,2014,LOCAL FLIGHTS,13,13,26
12,APR,2014,LOCAL FLIGHTS,17,16,33
13,APR,2014,LOCAL FLIGHTS,4,4,8
14,APR,2014,LOCAL FLIGHTS,14,14,28
15,APR,2014,LOCAL FLIGHTS,24,21,45
16,APR,2014,LOCAL FLIGHTS,14,14,28
17,APR,2014,LOCAL FLIGHTS,14,14,28
18,APR,2014,LOCAL FLIGHTS,15,15,30
19,APR,2014,LOCAL FLIGHTS,0,0,0
20,APR,2014,LOCAL FLIGHTS,0,0,0
21,APR,2014,LOCAL FLIGHTS,4,4,8
22,APR,2014,LOCAL FLIGHTS,15,15,30
23,APR,2014,LOCAL FLIGHTS,16,17,33
24,APR,2014,LOCAL FLIGHTS,12,12,24
25,APR,2014,LOCAL FLIGHTS,11,12,23
26,APR,2014,LOCAL FLIGHTS,11,11,22
27,APR,2014,LOCAL FLIGHTS,8,8,16
28,APR,2014,LOCAL FLIGHTS,10,9,19
29,APR,2014,LOCAL FLIGHTS,7,7,14
30,APR,2014,LOCAL FLIGHTS,18,18,36
1,APR,2014,HELICOPTER FLIGHTS,0,0,0
2,APR,2014,HELICOPTER FLIGHTS,2,2,4
3,APR,2014,HELICOPTER FLIGHTS,0,0,0
4,APR,2014,HELICOPTER FLIGHTS,2,2,4
5,APR,2014,HELICOPTER FLIGHTS,1,1,2
6,APR,2014,HELICOPTER FLIGHTS,0,2,2
7,APR,2014,HELICOPTER FLIGHTS,1,1,2
8,APR,2014,HELICOPTER FLIGHTS,1,1,2
9,APR,2014,HELICOPTER FLIGHTS,3,3,6
10,APR,2014,HELICOPTER FLIGHTS,3,3,6
11,APR,2014,HELICOPTER FLIGHTS,1,1,2
12,APR,2014,HELICOPTER FLIGHTS,0,0,0
13,APR,2014,HELICOPTER FLIGHTS,0,0,0
14,APR,2014,HELICOPTER FLIGHTS,4,4,8
15,APR,2014,HELICOPTER FLIGHTS,2,2,4
16,APR,2014,HELICOPTER FLIGHTS,1,1,2
17,APR,2014,HELICOPTER FLIGHTS,2,2,4
18,APR,2014,HELICOPTER FLIGHTS,0,0,0
19,APR,2014,HELICOPTER FLIGHTS,0,0,0
20,APR,2014,HELICOPTER FLIGHTS,1,1,2
21,APR,2014,HELICOPTER FLIGHTS,0,0,0
22,APR,2014,HELICOPTER FLIGHTS,2,2,4
23,APR,2014,HELICOPTER FLIGHTS,2,2,4
24,APR,2014,HELICOPTER FLIGHTS,2,1,3
25,APR,2014,HELICOPTER FLIGHTS,1,1,2
26,APR,2014,HELICOPTER FLIGHTS,0,0,0
27,APR,2014,HELICOPTER FLIGHTS,0,0,0
28,APR,2014,HELICOPTER FLIGHTS,1,1,2
29,APR,2014,HELICOPTER FLIGHTS,1,1,2
30,APR,2014,HELICOPTER FLIGHTS,1,1,2
1,MAY,2014,INTERNATIONAL FLIGHTS,61,63,124
2,MAY,2014,INTERNATIONAL FLIGHTS,61,58,119
3,MAY,2014,INTERNATIONAL FLIGHTS,68,69,137
4,MAY,2014,INTERNATIONAL FLIGHTS,81,81,162
5,MAY,2014,INTERNATIONAL FLIGHTS,60,63,123
6,MAY,2014,INTERNATIONAL FLIGHTS,50,51,101
7,MAY,2014,INTERNATIONAL FLIGHTS,73,71,144
8,MAY,2014,INTERNATIONAL FLIGHTS,63,62,125
9,MAY,2014,INTERNATIONAL FLIGHTS,66,65,131
10,MAY,2014,INTERNATIONAL FLIGHTS,76,80,156
11,MAY,2014,INTERNATIONAL FLIGHTS,85,86,171
12,MAY,2014,INTERNATIONAL FLIGHTS,59,63,122
13,MAY,2014,INTERNATIONAL FLIGHTS,58,50,108
14,MAY,2014,INTERNATIONAL FLIGHTS,73,78,151
15,MAY,2014,INTERNATIONAL FLIGHTS,66,62,128
16,MAY,2014,INTERNATIONAL FLIGHTS,72,70,142
17,MAY,2014,INTERNATIONAL FLIGHTS,75,76,151
18,MAY,2014,INTERNATIONAL FLIGHTS,75,78,153
19,MAY,2014,INTERNATIONAL FLIGHTS,76,79,155
20,MAY,2014,INTERNATIONAL FLIGHTS,61,64,125
21,MAY,2014,INTERNATIONAL FLIGHTS,85,79,164
22,MAY,2014,INTERNATIONAL FLIGHTS,53,60,113
23,MAY,2014,INTERNATIONAL FLIGHTS,70,66,136
24,MAY,2014,INTERNATIONAL FLIGHTS,69,76,145
25,MAY,2014,INTERNATIONAL FLIGHTS,78,81,159
26,MAY,2014,INTERNATIONAL FLIGHTS,78,78,156
27,MAY,2014,INTERNATIONAL FLIGHTS,66,63,129
28,MAY,2014,INTERNATIONAL FLIGHTS,81,83,164
29,MAY,2014,INTERNATIONAL FLIGHTS,64,66,130
30,MAY,2014,INTERNATIONAL FLIGHTS,72,69,141
31,MAY,2014,INTERNATIONAL FLIGHTS,78,80,158
1,MAY,2014,LOCAL FLIGHTS,8,8,16
2,MAY,2014,LOCAL FLIGHTS,10,10,20
3,MAY,2014,LOCAL FLIGHTS,23,21,44
4,MAY,2014,LOCAL FLIGHTS,1,1,2
5,MAY,2014,LOCAL FLIGHTS,10,10,20
6,MAY,2014,LOCAL FLIGHTS,6,6,12
7,MAY,2014,LOCAL FLIGHTS,13,13,26
8,MAY,2014,LOCAL FLIGHTS,0,0,0
9,MAY,2014,LOCAL FLIGHTS,9,9,18
10,MAY,2014,LOCAL FLIGHTS,8,8,16
11,MAY,2014,LOCAL FLIGHTS,1,1,2
12,MAY,2014,LOCAL FLIGHTS,10,10,20
13,MAY,2014,LOCAL FLIGHTS,10,10,20
14,MAY,2014,LOCAL FLIGHTS,13,13,26
15,MAY,2014,LOCAL FLIGHTS,10,10,20
16,MAY,2014,LOCAL FLIGHTS,14,13,27
17,MAY,2014,LOCAL FLIGHTS,17,17,34
18,MAY,2014,LOCAL FLIGHTS,1,1,2
19,MAY,2014,LOCAL FLIGHTS,9,9,18
20,MAY,2014,LOCAL FLIGHTS,15,16,31
21,MAY,2014,LOCAL FLIGHTS,11,10,21
22,MAY,2014,LOCAL FLIGHTS,14,14,28
23,MAY,2014,LOCAL FLIGHTS,14,13,27
24,MAY,2014,LOCAL FLIGHTS,9,9,18
25,MAY,2014,LOCAL FLIGHTS,2,3,5
26,MAY,2014,LOCAL FLIGHTS,13,13,26
27,MAY,2014,LOCAL FLIGHTS,10,9,19
28,MAY,2014,LOCAL FLIGHTS,11,11,22
29,MAY,2014,LOCAL FLIGHTS,10,10,20
30,MAY,2014,LOCAL FLIGHTS,13,13,26
31,MAY,2014,LOCAL FLIGHTS,9,9,18
1,MAY,2014,HELICOPTER FLIGHTS,1,1,2
2,MAY,2014,HELICOPTER FLIGHTS,3,3,6
3,MAY,2014,HELICOPTER FLIGHTS,1,1,2
4,MAY,2014,HELICOPTER FLIGHTS,0,0,0
5,MAY,2014,HELICOPTER FLIGHTS,3,3,6
6,MAY,2014,HELICOPTER FLIGHTS,1,1,2
7,MAY,2014,HELICOPTER FLIGHTS,1,1,2
8,MAY,2014,HELICOPTER FLIGHTS,0,0,0
9,MAY,2014,HELICOPTER FLIGHTS,2,2,4
10,MAY,2014,HELICOPTER FLIGHTS,1,1,2
11,MAY,2014,HELICOPTER FLIGHTS,0,0,0
12,MAY,2014,HELICOPTER FLIGHTS,3,3,6
13,MAY,2014,HELICOPTER FLIGHTS,1,1,2
14,MAY,2014,HELICOPTER FLIGHTS,3,3,6
15,MAY,2014,HELICOPTER FLIGHTS,5,5,10
16,MAY,2014,HELICOPTER FLIGHTS,2,2,4
17,MAY,2014,HELICOPTER FLIGHTS,0,0,0
18,MAY,2014,HELICOPTER FLIGHTS,0,0,0
19,MAY,2014,HELICOPTER FLIGHTS,1,1,2
20,MAY,2014,HELICOPTER FLIGHTS,2,2,4
21,MAY,2014,HELICOPTER FLIGHTS,3,3,6
22,MAY,2014,HELICOPTER FLIGHTS,3,4,7
23,MAY,2014,HELICOPTER FLIGHTS,2,2,4
24,MAY,2014,HELICOPTER FLIGHTS,1,1,2
25,MAY,2014,HELICOPTER FLIGHTS,0,0,0
26,MAY,2014,HELICOPTER FLIGHTS,2,2,4
27,MAY,2014,HELICOPTER FLIGHTS,2,2,4
28,MAY,2014,HELICOPTER FLIGHTS,2,2,4
29,MAY,2014,HELICOPTER FLIGHTS,2,2,4
30,MAY,2014,HELICOPTER FLIGHTS,2,2,4
31,MAY,2014,HELICOPTER FLIGHTS,0,0,0
1,JUN,2014,INTERNATIONAL FLIGHTS,93,97,190
2,JUN,2014,INTERNATIONAL FLIGHTS,73,76,149
3,JUN,2014,INTERNATIONAL FLIGHTS,64,56,120
4,JUN,2014,INTERNATIONAL FLIGHTS,89,85,174
5,JUN,2014,INTERNATIONAL FLIGHTS,61,64,125
6,JUN,2014,INTERNATIONAL FLIGHTS,88,91,179
7,JUN,2014,INTERNATIONAL FLIGHTS,82,81,163
8,JUN,2014,INTERNATIONAL FLIGHTS,91,91,182
9,JUN,2014,INTERNATIONAL FLIGHTS,74,76,150
10,JUN,2014,INTERNATIONAL FLIGHTS,72,74,146
11,JUN,2014,INTERNATIONAL FLIGHTS,84,78,162
12,JUN,2014,INTERNATIONAL FLIGHTS,67,72,139
13,JUN,2014,INTERNATIONAL FLIGHTS,81,79,160
14,JUN,2014,INTERNATIONAL FLIGHTS,80,82,162
15,JUN,2014,INTERNATIONAL FLIGHTS,94,96,190
16,JUN,2014,INTERNATIONAL FLIGHTS,83,82,165
17,JUN,2014,INTERNATIONAL FLIGHTS,66,62,128
18,JUN,2014,INTERNATIONAL FLIGHTS,87,87,174
19,JUN,2014,INTERNATIONAL FLIGHTS,62,54,116
20,JUN,2014,INTERNATIONAL FLIGHTS,82,81,163
21,JUN,2014,INTERNATIONAL FLIGHTS,77,80,157
22,JUN,2014,INTERNATIONAL FLIGHTS,90,87,177
23,JUN,2014,INTERNATIONAL FLIGHTS,86,86,172
24,JUN,2014,INTERNATIONAL FLIGHTS,65,64,129
25,JUN,2014,INTERNATIONAL FLIGHTS,94,92,186
26,JUN,2014,INTERNATIONAL FLIGHTS,69,77,146
27,JUN,2014,INTERNATIONAL FLIGHTS,85,80,165
28,JUN,2014,INTERNATIONAL FLIGHTS,79,84,163
29,JUN,2014,INTERNATIONAL FLIGHTS,89,93,182
30,JUN,2014,INTERNATIONAL FLIGHTS,86,84,170
1,JUN,2014,LOCAL FLIGHTS,1,1,2
2,JUN,2014,LOCAL FLIGHTS,7,7,14
3,JUN,2014,LOCAL FLIGHTS,15,13,28
4,JUN,2014,LOCAL FLIGHTS,15,15,30
5,JUN,2014,LOCAL FLIGHTS,2,2,4
6,JUN,2014,LOCAL FLIGHTS,9,9,18
7,JUN,2014,LOCAL FLIGHTS,7,7,14
8,JUN,2014,LOCAL FLIGHTS,3,3,6
9,JUN,2014,LOCAL FLIGHTS,1,1,2
10,JUN,2014,LOCAL FLIGHTS,9,9,18
11,JUN,2014,LOCAL FLIGHTS,8,8,16
12,JUN,2014,LOCAL FLIGHTS,21,21,42
13,JUN,2014,LOCAL FLIGHTS,8,11,19
14,JUN,2014,LOCAL FLIGHTS,7,8,15
15,JUN,2014,LOCAL FLIGHTS,2,2,4
16,JUN,2014,LOCAL FLIGHTS,15,15,30
17,JUN,2014,LOCAL FLIGHTS,12,12,24
18,JUN,2014,LOCAL FLIGHTS,10,10,20
19,JUN,2014,LOCAL FLIGHTS,14,14,28
20,JUN,2014,LOCAL FLIGHTS,6,6,12
21,JUN,2014,LOCAL FLIGHTS,2,2,4
22,JUN,2014,LOCAL FLIGHTS,0,0,0
23,JUN,2014,LOCAL FLIGHTS,6,6,12
24,JUN,2014,LOCAL FLIGHTS,6,6,12
25,JUN,2014,LOCAL FLIGHTS,10,10,20
26,JUN,2014,LOCAL FLIGHTS,10,10,20
27,JUN,2014,LOCAL FLIGHTS,7,7,14
28,JUN,2014,LOCAL FLIGHTS,7,7,14
29,JUN,2014,LOCAL FLIGHTS,3,3,6
30,JUN,2014,LOCAL FLIGHTS,12,15,27
1,JUN,2014,HELICOPTER FLIGHTS,1,1,2
2,JUN,2014,HELICOPTER FLIGHTS,2,2,4
3,JUN,2014,HELICOPTER FLIGHTS,2,2,4
4,JUN,2014,HELICOPTER FLIGHTS,3,3,6
5,JUN,2014,HELICOPTER FLIGHTS,2,2,4
6,JUN,2014,HELICOPTER FLIGHTS,2,2,4
7,JUN,2014,HELICOPTER FLIGHTS,0,0,0
8,JUN,2014,HELICOPTER FLIGHTS,0,0,0
9,JUN,2014,HELICOPTER FLIGHTS,2,2,4
10,JUN,2014,HELICOPTER FLIGHTS,2,2,4
11,JUN,2014,HELICOPTER FLIGHTS,2,2,4
12,JUN,2014,HELICOPTER FLIGHTS,2,2,4
13,JUN,2014,HELICOPTER FLIGHTS,2,2,4
14,JUN,2014,HELICOPTER FLIGHTS,0,0,0
15,JUN,2014,HELICOPTER FLIGHTS,1,2,3
16,JUN,2014,HELICOPTER FLIGHTS,2,6,8
17,JUN,2014,HELICOPTER FLIGHTS,3,3,6
18,JUN,2014,HELICOPTER FLIGHTS,3,5,8
19,JUN,2014,HELICOPTER FLIGHTS,1,1,2
20,JUN,2014,HELICOPTER FLIGHTS,1,1,2
21,JUN,2014,HELICOPTER FLIGHTS,0,0,0
22,JUN,2014,HELICOPTER FLIGHTS,0,0,0
23,JUN,2014,HELICOPTER FLIGHTS,2,2,4
24,JUN,2014,HELICOPTER FLIGHTS,4,4,8
25,JUN,2014,HELICOPTER FLIGHTS,1,1,2
26,JUN,2014,HELICOPTER FLIGHTS,3,3,6
27,JUN,2014,HELICOPTER FLIGHTS,1,1,2
28,JUN,2014,HELICOPTER FLIGHTS,1,1,2
29,JUN,2014,HELICOPTER FLIGHTS,1,1,2
30,JUN,2014,HELICOPTER FLIGHTS,2,2,4
1,JUL,2014,INTERNATIONAL FLIGHTS,73,72,145
2,JUL,2014,INTERNATIONAL FLIGHTS,88,85,173
3,JUL,2014,INTERNATIONAL FLIGHTS,73,80,153
4,JUL,2014,INTERNATIONAL FLIGHTS,86,77,163
5,JUL,2014,INTERNATIONAL FLIGHTS,83,88,171
6,JUL,2014,INTERNATIONAL FLIGHTS,92,92,184
7,JUL,2014,INTERNATIONAL FLIGHTS,86,90,176
8,JUL,2014,INTERNATIONAL FLIGHTS,79,78,157
9,JUL,2014,INTERNATIONAL FLIGHTS,96,92,188
10,JUL,2014,INTERNATIONAL FLIGHTS,76,84,160
11,JUL,2014,INTERNATIONAL FLIGHTS,84,80,164
12,JUL,2014,INTERNATIONAL FLIGHTS,83,85,168
13,JUL,2014,INTERNATIONAL FLIGHTS,90,88,178
14,JUL,2014,INTERNATIONAL FLIGHTS,91,91,182
15,JUL,2014,INTERNATIONAL FLIGHTS,76,70,146
16,JUL,2014,INTERNATIONAL FLIGHTS,89,93,182
17,JUL,2014,INTERNATIONAL FLIGHTS,77,78,155
18,JUL,2014,INTERNATIONAL FLIGHTS,89,84,173
19,JUL,2014,INTERNATIONAL FLIGHTS,84,90,174
20,JUL,2014,INTERNATIONAL FLIGHTS,97,94,191
21,JUL,2014,INTERNATIONAL FLIGHTS,101,108,209
22,JUL,2014,INTERNATIONAL FLIGHTS,80,78,158
23,JUL,2014,INTERNATIONAL FLIGHTS,103,98,201
24,JUL,2014,INTERNATIONAL FLIGHTS,82,86,168
25,JUL,2014,INTERNATIONAL FLIGHTS,88,88,176
26,JUL,2014,INTERNATIONAL FLIGHTS,80,84,164
27,JUL,2014,INTERNATIONAL FLIGHTS,97,93,190
28,JUL,2014,INTERNATIONAL FLIGHTS,90,92,182
29,JUL,2014,INTERNATIONAL FLIGHTS,87,82,169
30,JUL,2014,INTERNATIONAL FLIGHTS,100,102,202
31,JUL,2014,INTERNATIONAL FLIGHTS,80,80,160
1,JUL,2014,LOCAL FLIGHTS,9,11,20
2,JUL,2014,LOCAL FLIGHTS,6,6,12
3,JUL,2014,LOCAL FLIGHTS,7,7,14
4,JUL,2014,LOCAL FLIGHTS,12,12,24
5,JUL,2014,LOCAL FLIGHTS,13,13,26
6,JUL,2014,LOCAL FLIGHTS,3,3,6
7,JUL,2014,LOCAL FLIGHTS,10,10,20
8,JUL,2014,LOCAL FLIGHTS,10,10,20
9,JUL,2014,LOCAL FLIGHTS,6,6,12
10,JUL,2014,LOCAL FLIGHTS,9,9,18
11,JUL,2014,LOCAL FLIGHTS,11,11,22
12,JUL,2014,LOCAL FLIGHTS,7,7,14
13,JUL,2014,LOCAL FLIGHTS,0,0,0
14,JUL,2014,LOCAL FLIGHTS,10,11,21
15,JUL,2014,LOCAL FLIGHTS,7,9,16
16,JUL,2014,LOCAL FLIGHTS,7,7,14
17,JUL,2014,LOCAL FLIGHTS,8,8,16
18,JUL,2014,LOCAL FLIGHTS,8,8,16
19,JUL,2014,LOCAL FLIGHTS,6,6,12
20,JUL,2014,LOCAL FLIGHTS,1,1,2
21,JUL,2014,LOCAL FLIGHTS,9,9,18
22,JUL,2014,LOCAL FLIGHTS,5,5,10
23,JUL,2014,LOCAL FLIGHTS,6,6,12
24,JUL,2014,LOCAL FLIGHTS,8,8,16
25,JUL,2014,LOCAL FLIGHTS,9,9,18
26,JUL,2014,LOCAL FLIGHTS,5,5,10
27,JUL,2014,LOCAL FLIGHTS,3,3,6
28,JUL,2014,LOCAL FLIGHTS,7,8,15
29,JUL,2014,LOCAL FLIGHTS,9,10,19
30,JUL,2014,LOCAL FLIGHTS,14,14,28
31,JUL,2014,LOCAL FLIGHTS,16,18,34
1,JUL,2014,HELICOPTER FLIGHTS,1,1,2
2,JUL,2014,HELICOPTER FLIGHTS,2,2,4
3,JUL,2014,HELICOPTER FLIGHTS,2,2,4
4,JUL,2014,HELICOPTER FLIGHTS,2,2,4
5,JUL,2014,HELICOPTER FLIGHTS,0,0,0
6,JUL,2014,HELICOPTER FLIGHTS,2,2,4
7,JUL,2014,HELICOPTER FLIGHTS,2,2,4
8,JUL,2014,HELICOPTER FLIGHTS,2,2,4
9,JUL,2014,HELICOPTER FLIGHTS,1,1,2
10,JUL,2014,HELICOPTER FLIGHTS,1,1,2
11,JUL,2014,HELICOPTER FLIGHTS,1,1,2
12,JUL,2014,HELICOPTER FLIGHTS,0,0,0
13,JUL,2014,HELICOPTER FLIGHTS,1,1,2
14,JUL,2014,HELICOPTER FLIGHTS,2,2,4
15,JUL,2014,HELICOPTER FLIGHTS,1,1,2
16,JUL,2014,HELICOPTER FLIGHTS,1,1,2
17,JUL,2014,HELICOPTER FLIGHTS,1,1,2
18,JUL,2014,HELICOPTER FLIGHTS,0,0,0
19,JUL,2014,HELICOPTER FLIGHTS,0,0,0
20,JUL,2014,HELICOPTER FLIGHTS,0,0,0
21,JUL,2014,HELICOPTER FLIGHTS,0,0,0
22,JUL,2014,HELICOPTER FLIGHTS,0,0,0
23,JUL,2014,HELICOPTER FLIGHTS,0,0,0
24,JUL,2014,HELICOPTER FLIGHTS,0,0,0
25,JUL,2014,HELICOPTER FLIGHTS,0,0,0
26,JUL,2014,HELICOPTER FLIGHTS,0,0,0
27,JUL,2014,HELICOPTER FLIGHTS,0,0,0
28,JUL,2014,HELICOPTER FLIGHTS,1,1,2
29,JUL,2014,HELICOPTER FLIGHTS,1,1,2
30,JUL,2014,HELICOPTER FLIGHTS,0,0,0
31,JUL,2014,HELICOPTER FLIGHTS,0,0,0
1,AUG,2014,INTERNATIONAL FLIGHTS,93,94,187
2,AUG,2014,INTERNATIONAL FLIGHTS,85,90,175
3,AUG,2014,INTERNATIONAL FLIGHTS,95,98,193
4,AUG,2014,INTERNATIONAL FLIGHTS,90,97,187
5,AUG,2014,INTERNATIONAL FLIGHTS,86,82,168
6,AUG,2014,INTERNATIONAL FLIGHTS,95,97,192
7,AUG,2014,INTERNATIONAL FLIGHTS,74,78,152
8,AUG,2014,INTERNATIONAL FLIGHTS,96,90,186
9,AUG,2014,INTERNATIONAL FLIGHTS,83,87,170
10,AUG,2014,INTERNATIONAL FLIGHTS,90,91,181
11,AUG,2014,INTERNATIONAL FLIGHTS,87,90,177
12,AUG,2014,INTERNATIONAL FLIGHTS,77,79,156
13,AUG,2014,INTERNATIONAL FLIGHTS,95,96,191
14,AUG,2014,INTERNATIONAL FLIGHTS,79,83,162
15,AUG,2014,INTERNATIONAL FLIGHTS,80,76,156
16,AUG,2014,INTERNATIONAL FLIGHTS,83,89,172
17,AUG,2014,INTERNATIONAL FLIGHTS,93,89,182
18,AUG,2014,INTERNATIONAL FLIGHTS,88,86,174
19,AUG,2014,INTERNATIONAL FLIGHTS,80,77,157
20,AUG,2014,INTERNATIONAL FLIGHTS,89,88,177
21,AUG,2014,INTERNATIONAL FLIGHTS,76,76,152
22,AUG,2014,INTERNATIONAL FLIGHTS,81,86,167
23,AUG,2014,INTERNATIONAL FLIGHTS,88,88,176
24,AUG,2014,INTERNATIONAL FLIGHTS,93,91,184
25,AUG,2014,INTERNATIONAL FLIGHTS,100,91,191
26,AUG,2014,INTERNATIONAL FLIGHTS,78,82,160
27,AUG,2014,INTERNATIONAL FLIGHTS,99,101,200
28,AUG,2014,INTERNATIONAL FLIGHTS,73,80,153
29,AUG,2014,INTERNATIONAL FLIGHTS,88,86,174
30,AUG,2014,INTERNATIONAL FLIGHTS,88,91,179
31,AUG,2014,INTERNATIONAL FLIGHTS,92,93,185
1,AUG,2014,LOCAL FLIGHTS,12,12,24
2,AUG,2014,LOCAL FLIGHTS,12,12,24
3,AUG,2014,LOCAL FLIGHTS,1,1,2
4,AUG,2014,LOCAL FLIGHTS,8,8,16
5,AUG,2014,LOCAL FLIGHTS,9,8,17
6,AUG,2014,LOCAL FLIGHTS,14,14,28
7,AUG,2014,LOCAL FLIGHTS,8,8,16
8,AUG,2014,LOCAL FLIGHTS,14,15,29
9,AUG,2014,LOCAL FLIGHTS,13,13,26
10,AUG,2014,LOCAL FLIGHTS,0,0,0
11,AUG,2014,LOCAL FLIGHTS,11,11,22
12,AUG,2014,LOCAL FLIGHTS,7,7,14
13,AUG,2014,LOCAL FLIGHTS,5,5,10
14,AUG,2014,LOCAL FLIGHTS,3,3,6
15,AUG,2014,LOCAL FLIGHTS,4,4,8
16,AUG,2014,LOCAL FLIGHTS,8,8,16
17,AUG,2014,LOCAL FLIGHTS,2,2,4
18,AUG,2014,LOCAL FLIGHTS,4,5,9
19,AUG,2014,LOCAL FLIGHTS,11,11,22
20,AUG,2014,LOCAL FLIGHTS,10,10,20
21,AUG,2014,LOCAL FLIGHTS,13,13,26
22,AUG,2014,LOCAL FLIGHTS,10,10,20
23,AUG,2014,LOCAL FLIGHTS,9,9,18
24,AUG,2014,LOCAL FLIGHTS,3,3,6
25,AUG,2014,LOCAL FLIGHTS,6,6,12
26,AUG,2014,LOCAL FLIGHTS,9,9,18
27,AUG,2014,LOCAL FLIGHTS,9,10,19
28,AUG,2014,LOCAL FLIGHTS,5,5,10
29,AUG,2014,LOCAL FLIGHTS,11,11,22
30,AUG,2014,LOCAL FLIGHTS,14,14,28
31,AUG,2014,LOCAL FLIGHTS,1,1,2
1,AUG,2014,HELICOPTER FLIGHTS,0,0,0
2,AUG,2014,HELICOPTER FLIGHTS,0,0,0
3,AUG,2014,HELICOPTER FLIGHTS,0,0,0
4,AUG,2014,HELICOPTER FLIGHTS,0,0,0
5,AUG,2014,HELICOPTER FLIGHTS,0,0,0
6,AUG,2014,HELICOPTER FLIGHTS,0,0,0
7,AUG,2014,HELICOPTER FLIGHTS,0,1,1
8,AUG,2014,HELICOPTER FLIGHTS,0,0,0
9,AUG,2014,HELICOPTER FLIGHTS,0,0,0
10,AUG,2014,HELICOPTER FLIGHTS,0,0,0
11,AUG,2014,HELICOPTER FLIGHTS,0,0,0
12,AUG,2014,HELICOPTER FLIGHTS,0,0,0
13,AUG,2014,HELICOPTER FLIGHTS,0,0,0
14,AUG,2014,HELICOPTER FLIGHTS,0,0,0
15,AUG,2014,HELICOPTER FLIGHTS,0,0,0
16,AUG,2014,HELICOPTER FLIGHTS,0,0,0
17,AUG,2014,HELICOPTER FLIGHTS,0,0,0
18,AUG,2014,HELICOPTER FLIGHTS,0,0,0
19,AUG,2014,HELICOPTER FLIGHTS,0,0,0
20,AUG,2014,HELICOPTER FLIGHTS,2,2,4
21,AUG,2014,HELICOPTER FLIGHTS,0,0,0
22,AUG,2014,HELICOPTER FLIGHTS,0,0,0
23,AUG,2014,HELICOPTER FLIGHTS,0,0,0
24,AUG,2014,HELICOPTER FLIGHTS,0,0,0
25,AUG,2014,HELICOPTER FLIGHTS,0,0,0
26,AUG,2014,HELICOPTER FLIGHTS,0,0,0
27,AUG,2014,HELICOPTER FLIGHTS,0,0,0
28,AUG,2014,HELICOPTER FLIGHTS,0,0,0
29,AUG,2014,HELICOPTER FLIGHTS,0,0,0
30,AUG,2014,HELICOPTER FLIGHTS,0,0,0
31,AUG,2014,HELICOPTER FLIGHTS,0,0,0
1,SEP,2014,INTERNATIONAL FLIGHTS,85,83,168
2,SEP,2014,INTERNATIONAL FLIGHTS,70,70,140
3,SEP,2014,INTERNATIONAL FLIGHTS,92,93,185
4,SEP,2014,INTERNATIONAL FLIGHTS,63,65,128
5,SEP,2014,INTERNATIONAL FLIGHTS,82,76,158
6,SEP,2014,INTERNATIONAL FLIGHTS,86,86,172
7,SEP,2014,INTERNATIONAL FLIGHTS,88,92,180
8,SEP,2014,INTERNATIONAL FLIGHTS,86,89,175
9,SEP,2014,INTERNATIONAL FLIGHTS,75,68,143
10,SEP,2014,INTERNATIONAL FLIGHTS,91,96,187
11,SEP,2014,INTERNATIONAL FLIGHTS,71,77,148
12,SEP,2014,INTERNATIONAL FLIGHTS,78,77,155
13,SEP,2014,INTERNATIONAL FLIGHTS,78,78,156
14,SEP,2014,INTERNATIONAL FLIGHTS,94,89,183
15,SEP,2014,INTERNATIONAL FLIGHTS,80,85,165
16,SEP,2014,INTERNATIONAL FLIGHTS,74,69,143
17,SEP,2014,INTERNATIONAL FLIGHTS,81,86,167
18,SEP,2014,INTERNATIONAL FLIGHTS,82,79,161
19,SEP,2014,INTERNATIONAL FLIGHTS,77,77,154
20,SEP,2014,INTERNATIONAL FLIGHTS,78,75,153
21,SEP,2014,INTERNATIONAL FLIGHTS,91,92,183
22,SEP,2014,INTERNATIONAL FLIGHTS,82,84,166
23,SEP,2014,INTERNATIONAL FLIGHTS,67,67,134
24,SEP,2014,INTERNATIONAL FLIGHTS,85,84,169
25,SEP,2014,INTERNATIONAL FLIGHTS,64,63,127
26,SEP,2014,INTERNATIONAL FLIGHTS,80,82,162
27,SEP,2014,INTERNATIONAL FLIGHTS,76,80,156
28,SEP,2014,INTERNATIONAL FLIGHTS,89,87,176
29,SEP,2014,INTERNATIONAL FLIGHTS,74,77,151
30,SEP,2014,INTERNATIONAL FLIGHTS,64,58,122
1,SEP,2014,LOCAL FLIGHTS,4,4,8
2,SEP,2014,LOCAL FLIGHTS,17,17,34
3,SEP,2014,LOCAL FLIGHTS,9,9,18
4,SEP,2014,LOCAL FLIGHTS,12,12,24
5,SEP,2014,LOCAL FLIGHTS,6,6,12
6,SEP,2014,LOCAL FLIGHTS,10,9,19
7,SEP,2014,LOCAL FLIGHTS,3,3,6
8,SEP,2014,LOCAL FLIGHTS,11,11,22
9,SEP,2014,LOCAL FLIGHTS,9,9,18
10,SEP,2014,LOCAL FLIGHTS,8,8,16
11,SEP,2014,LOCAL FLIGHTS,6,6,12
12,SEP,2014,LOCAL FLIGHTS,9,9,18
13,SEP,2014,LOCAL FLIGHTS,14,14,28
14,SEP,2014,LOCAL FLIGHTS,3,3,6
15,SEP,2014,LOCAL FLIGHTS,6,6,12
16,SEP,2014,LOCAL FLIGHTS,5,5,10
17,SEP,2014,LOCAL FLIGHTS,10,10,20
18,SEP,2014,LOCAL FLIGHTS,1,2,3
19,SEP,2014,LOCAL FLIGHTS,4,4,8
20,SEP,2014,LOCAL FLIGHTS,7,9,16
21,SEP,2014,LOCAL FLIGHTS,3,3,6
22,SEP,2014,LOCAL FLIGHTS,6,6,12
23,SEP,2014,LOCAL FLIGHTS,7,7,14
24,SEP,2014,LOCAL FLIGHTS,6,5,11
25,SEP,2014,LOCAL FLIGHTS,4,4,8
26,SEP,2014,LOCAL FLIGHTS,4,4,8
27,SEP,2014,LOCAL FLIGHTS,6,6,12
28,SEP,2014,LOCAL FLIGHTS,0,0,0
29,SEP,2014,LOCAL FLIGHTS,5,5,10
30,SEP,2014,LOCAL FLIGHTS,10,10,20
1,SEP,2014,HELICOPTER FLIGHTS,0,0,0
2,SEP,2014,HELICOPTER FLIGHTS,0,0,0
3,SEP,2014,HELICOPTER FLIGHTS,1,1,2
4,SEP,2014,HELICOPTER FLIGHTS,0,0,0
5,SEP,2014,HELICOPTER FLIGHTS,1,1,2
6,SEP,2014,HELICOPTER FLIGHTS,0,0,0
7,SEP,2014,HELICOPTER FLIGHTS,0,0,0
8,SEP,2014,HELICOPTER FLIGHTS,1,1,2
9,SEP,2014,HELICOPTER FLIGHTS,1,1,2
10,SEP,2014,HELICOPTER FLIGHTS,0,1,1
11,SEP,2014,HELICOPTER FLIGHTS,0,0,0
12,SEP,2014,HELICOPTER FLIGHTS,1,1,2
13,SEP,2014,HELICOPTER FLIGHTS,0,0,0
14,SEP,2014,HELICOPTER FLIGHTS,0,0,0
15,SEP,2014,HELICOPTER FLIGHTS,0,0,0
16,SEP,2014,HELICOPTER FLIGHTS,1,1,2
17,SEP,2014,HELICOPTER FLIGHTS,1,1,2
18,SEP,2014,HELICOPTER FLIGHTS,3,3,6
19,SEP,2014,HELICOPTER FLIGHTS,1,1,2
20,SEP,2014,HELICOPTER FLIGHTS,0,0,0
21,SEP,2014,HELICOPTER FLIGHTS,0,0,0
22,SEP,2014,HELICOPTER FLIGHTS,0,0,0
23,SEP,2014,HELICOPTER FLIGHTS,0,0,0
24,SEP,2014,HELICOPTER FLIGHTS,4,5,9
25,SEP,2014,HELICOPTER FLIGHTS,5,5,10
26,SEP,2014,HELICOPTER FLIGHTS,0,0,0
27,SEP,2014,HELICOPTER FLIGHTS,0,0,0
28,SEP,2014,HELICOPTER FLIGHTS,0,0,0
29,SEP,2014,HELICOPTER FLIGHTS,0,0,0
30,SEP,2014,HELICOPTER FLIGHTS,2,2,4
1,OCT,2014,INTERNATIONAL FLIGHTS,83,82,165
2,OCT,2014,INTERNATIONAL FLIGHTS,64,68,132
3,OCT,2014,INTERNATIONAL FLIGHTS,80,76,156
4,OCT,2014,INTERNATIONAL FLIGHTS,76,79,155
5,OCT,2014,INTERNATIONAL FLIGHTS,82,87,169
6,OCT,2014,INTERNATIONAL FLIGHTS,72,71,143
7,OCT,2014,INTERNATIONAL FLIGHTS,64,62,126
8,OCT,2014,INTERNATIONAL FLIGHTS,82,81,163
9,OCT,2014,INTERNATIONAL FLIGHTS,67,68,135
10,OCT,2014,INTERNATIONAL FLIGHTS,78,75,153
11,OCT,2014,INTERNATIONAL FLIGHTS,79,83,162
12,OCT,2014,INTERNATIONAL FLIGHTS,85,86,171
13,OCT,2014,INTERNATIONAL FLIGHTS,66,64,130
14,OCT,2014,INTERNATIONAL FLIGHTS,64,67,131
15,OCT,2014,INTERNATIONAL FLIGHTS,78,75,153
16,OCT,2014,INTERNATIONAL FLIGHTS,67,69,136
17,OCT,2014,INTERNATIONAL FLIGHTS,73,76,149
18,OCT,2014,INTERNATIONAL FLIGHTS,72,73,145
19,OCT,2014,INTERNATIONAL FLIGHTS,80,84,164
20,OCT,2014,INTERNATIONAL FLIGHTS,61,61,122
21,OCT,2014,INTERNATIONAL FLIGHTS,61,58,119
22,OCT,2014,INTERNATIONAL FLIGHTS,72,81,153
23,OCT,2014,INTERNATIONAL FLIGHTS,55,57,112
24,OCT,2014,INTERNATIONAL FLIGHTS,65,66,131
25,OCT,2014,INTERNATIONAL FLIGHTS,72,76,148
26,OCT,2014,INTERNATIONAL FLIGHTS,68,63,131
27,OCT,2014,INTERNATIONAL FLIGHTS,46,52,98
28,OCT,2014,INTERNATIONAL FLIGHTS,45,41,86
29,OCT,2014,INTERNATIONAL FLIGHTS,72,73,145
30,OCT,2014,INTERNATIONAL FLIGHTS,40,39,79
31,OCT,2014,INTERNATIONAL FLIGHTS,49,48,97
1,OCT,2014,LOCAL FLIGHTS,8,8,16
2,OCT,2014,LOCAL FLIGHTS,6,6,12
3,OCT,2014,LOCAL FLIGHTS,7,7,14
4,OCT,2014,LOCAL FLIGHTS,15,15,30
5,OCT,2014,LOCAL FLIGHTS,1,1,2
6,OCT,2014,LOCAL FLIGHTS,5,5,10
7,OCT,2014,LOCAL FLIGHTS,10,12,22
8,OCT,2014,LOCAL FLIGHTS,10,10,20
9,OCT,2014,LOCAL FLIGHTS,5,5,10
10,OCT,2014,LOCAL FLIGHTS,9,9,18
11,OCT,2014,LOCAL FLIGHTS,11,10,21
12,OCT,2014,LOCAL FLIGHTS,0,0,0
13,OCT,2014,LOCAL FLIGHTS,6,6,12
14,OCT,2014,LOCAL FLIGHTS,7,7,14
15,OCT,2014,LOCAL FLIGHTS,4,4,8
16,OCT,2014,LOCAL FLIGHTS,5,6,11
17,OCT,2014,LOCAL FLIGHTS,8,8,16
18,OCT,2014,LOCAL FLIGHTS,15,15,30
19,OCT,2014,LOCAL FLIGHTS,0,0,0
20,OCT,2014,LOCAL FLIGHTS,8,8,16
21,OCT,2014,LOCAL FLIGHTS,8,8,16
22,OCT,2014,LOCAL FLIGHTS,11,11,22
23,OCT,2014,LOCAL FLIGHTS,5,5,10
24,OCT,2014,LOCAL FLIGHTS,3,3,6
25,OCT,2014,LOCAL FLIGHTS,8,8,16
26,OCT,2014,LOCAL FLIGHTS,0,0,0
27,OCT,2014,LOCAL FLIGHTS,7,7,14
28,OCT,2014,LOCAL FLIGHTS,9,9,18
29,OCT,2014,LOCAL FLIGHTS,9,9,18
30,OCT,2014,LOCAL FLIGHTS,2,2,4
31,OCT,2014,LOCAL FLIGHTS,10,10,20
1,OCT,2014,HELICOPTER FLIGHTS,0,0,0
2,OCT,2014,HELICOPTER FLIGHTS,0,0,0
3,OCT,2014,HELICOPTER FLIGHTS,4,4,8
4,OCT,2014,HELICOPTER FLIGHTS,1,1,2
5,OCT,2014,HELICOPTER FLIGHTS,0,0,0
6,OCT,2014,HELICOPTER FLIGHTS,0,0,0
7,OCT,2014,HELICOPTER FLIGHTS,4,4,8
8,OCT,2014,HELICOPTER FLIGHTS,3,3,6
9,OCT,2014,HELICOPTER FLIGHTS,3,3,6
10,OCT,2014,HELICOPTER FLIGHTS,3,3,6
11,OCT,2014,HELICOPTER FLIGHTS,0,1,1
12,OCT,2014,HELICOPTER FLIGHTS,0,0,0
13,OCT,2014,HELICOPTER FLIGHTS,2,2,4
14,OCT,2014,HELICOPTER FLIGHTS,3,3,6
15,OCT,2014,HELICOPTER FLIGHTS,2,2,4
16,OCT,2014,HELICOPTER FLIGHTS,0,0,0
17,OCT,2014,HELICOPTER FLIGHTS,3,3,6
18,OCT,2014,HELICOPTER FLIGHTS,0,0,0
19,OCT,2014,HELICOPTER FLIGHTS,1,0,1
20,OCT,2014,HELICOPTER FLIGHTS,1,1,2
21,OCT,2014,HELICOPTER FLIGHTS,1,1,2
22,OCT,2014,HELICOPTER FLIGHTS,5,5,10
23,OCT,2014,HELICOPTER FLIGHTS,3,3,6
24,OCT,2014,HELICOPTER FLIGHTS,2,2,4
25,OCT,2014,HELICOPTER FLIGHTS,2,2,4
26,OCT,2014,HELICOPTER FLIGHTS,2,2,4
27,OCT,2014,HELICOPTER FLIGHTS,3,3,6
28,OCT,2014,HELICOPTER FLIGHTS,3,3,6
29,OCT,2014,HELICOPTER FLIGHTS,3,2,5
30,OCT,2014,HELICOPTER FLIGHTS,0,1,1
31,OCT,2014,HELICOPTER FLIGHTS,2,2,4
1,NOV,2014,INTERNATIONAL FLIGHTS,68,67,135
2,NOV,2014,INTERNATIONAL FLIGHTS,69,72,141
3,NOV,2014,INTERNATIONAL FLIGHTS,40,49,89
4,NOV,2014,INTERNATIONAL FLIGHTS,42,44,86
5,NOV,2014,INTERNATIONAL FLIGHTS,53,50,103
6,NOV,2014,INTERNATIONAL FLIGHTS,41,43,84
7,NOV,2014,INTERNATIONAL FLIGHTS,52,51,103
8,NOV,2014,INTERNATIONAL FLIGHTS,51,52,103
9,NOV,2014,INTERNATIONAL FLIGHTS,52,48,100
10,NOV,2014,INTERNATIONAL FLIGHTS,49,51,100
11,NOV,2014,INTERNATIONAL FLIGHTS,34,40,74
12,NOV,2014,INTERNATIONAL FLIGHTS,49,47,96
13,NOV,2014,INTERNATIONAL FLIGHTS,40,36,76
14,NOV,2014,INTERNATIONAL FLIGHTS,40,37,77
15,NOV,2014,INTERNATIONAL FLIGHTS,47,53,100
16,NOV,2014,INTERNATIONAL FLIGHTS,53,51,104
17,NOV,2014,INTERNATIONAL FLIGHTS,40,40,80
18,NOV,2014,INTERNATIONAL FLIGHTS,41,42,83
19,NOV,2014,INTERNATIONAL FLIGHTS,45,42,87
20,NOV,2014,INTERNATIONAL FLIGHTS,37,40,77
21,NOV,2014,INTERNATIONAL FLIGHTS,40,37,77
22,NOV,2014,INTERNATIONAL FLIGHTS,50,51,101
23,NOV,2014,INTERNATIONAL FLIGHTS,47,45,92
24,NOV,2014,INTERNATIONAL FLIGHTS,41,44,85
25,NOV,2014,INTERNATIONAL FLIGHTS,44,37,81
26,NOV,2014,INTERNATIONAL FLIGHTS,47,56,103
27,NOV,2014,INTERNATIONAL FLIGHTS,32,35,67
28,NOV,2014,INTERNATIONAL FLIGHTS,45,47,92
29,NOV,2014,INTERNATIONAL FLIGHTS,51,47,98
30,NOV,2014,INTERNATIONAL FLIGHTS,46,46,92
1,NOV,2014,LOCAL FLIGHTS,14,9,23
2,NOV,2014,LOCAL FLIGHTS,1,1,2
3,NOV,2014,LOCAL FLIGHTS,8,8,16
4,NOV,2014,LOCAL FLIGHTS,8,8,16
5,NOV,2014,LOCAL FLIGHTS,9,2,11
6,NOV,2014,LOCAL FLIGHTS,10,10,20
7,NOV,2014,LOCAL FLIGHTS,9,9,18
8,NOV,2014,LOCAL FLIGHTS,14,14,28
9,NOV,2014,LOCAL FLIGHTS,1,1,2
10,NOV,2014,LOCAL FLIGHTS,4,4,8
11,NOV,2014,LOCAL FLIGHTS,7,7,14
12,NOV,2014,LOCAL FLIGHTS,9,9,18
13,NOV,2014,LOCAL FLIGHTS,0,0,0
14,NOV,2014,LOCAL FLIGHTS,6,6,12
15,NOV,2014,LOCAL FLIGHTS,9,9,18
16,NOV,2014,LOCAL FLIGHTS,0,0,0
17,NOV,2014,LOCAL FLIGHTS,16,16,32
18,NOV,2014,LOCAL FLIGHTS,14,14,28
19,NOV,2014,LOCAL FLIGHTS,9,9,18
20,NOV,2014,LOCAL FLIGHTS,5,5,10
21,NOV,2014,LOCAL FLIGHTS,10,10,20
22,NOV,2014,LOCAL FLIGHTS,18,18,36
23,NOV,2014,LOCAL FLIGHTS,6,6,12
24,NOV,2014,LOCAL FLIGHTS,10,10,20
25,NOV,2014,LOCAL FLIGHTS,7,6,13
26,NOV,2014,LOCAL FLIGHTS,10,10,20
27,NOV,2014,LOCAL FLIGHTS,10,10,20
28,NOV,2014,LOCAL FLIGHTS,14,14,28
29,NOV,2014,LOCAL FLIGHTS,15,15,30
30,NOV,2014,LOCAL FLIGHTS,2,2,4
1,NOV,2014,HELICOPTER FLIGHTS,5,0,5
2,NOV,2014,HELICOPTER FLIGHTS,0,0,0
3,NOV,2014,HELICOPTER FLIGHTS,5,4,9
4,NOV,2014,HELICOPTER FLIGHTS,3,4,7
5,NOV,2014,HELICOPTER FLIGHTS,1,2,3
6,NOV,2014,HELICOPTER FLIGHTS,2,2,4
7,NOV,2014,HELICOPTER FLIGHTS,2,2,4
8,NOV,2014,HELICOPTER FLIGHTS,0,0,0
9,NOV,2014,HELICOPTER FLIGHTS,0,0,0
10,NOV,2014,HELICOPTER FLIGHTS,1,1,2
11,NOV,2014,HELICOPTER FLIGHTS,2,2,4
12,NOV,2014,HELICOPTER FLIGHTS,2,3,5
13,NOV,2014,HELICOPTER FLIGHTS,0,0,0
14,NOV,2014,HELICOPTER FLIGHTS,3,3,6
15,NOV,2014,HELICOPTER FLIGHTS,0,0,0
16,NOV,2014,HELICOPTER FLIGHTS,1,1,2
17,NOV,2014,HELICOPTER FLIGHTS,2,2,4
18,NOV,2014,HELICOPTER FLIGHTS,2,2,4
19,NOV,2014,HELICOPTER FLIGHTS,5,5,10
20,NOV,2014,HELICOPTER FLIGHTS,1,1,2
21,NOV,2014,HELICOPTER FLIGHTS,3,3,6
22,NOV,2014,HELICOPTER FLIGHTS,1,1,2
23,NOV,2014,HELICOPTER FLIGHTS,0,0,0
24,NOV,2014,HELICOPTER FLIGHTS,1,1,2
25,NOV,2014,HELICOPTER FLIGHTS,1,2,3
26,NOV,2014,HELICOPTER FLIGHTS,4,4,8
27,NOV,2014,HELICOPTER FLIGHTS,3,3,6
28,NOV,2014,HELICOPTER FLIGHTS,3,3,6
29,NOV,2014,HELICOPTER FLIGHTS,3,3,6
30,NOV,2014,HELICOPTER FLIGHTS,0,0,0
1,DEC,2014,INTERNATIONAL FLIGHTS,35,38,73
2,DEC,2014,INTERNATIONAL FLIGHTS,40,40,80
3,DEC,2014,INTERNATIONAL FLIGHTS,37,40,77
4,DEC,2014,INTERNATIONAL FLIGHTS,39,39,78
5,DEC,2014,INTERNATIONAL FLIGHTS,39,38,77
6,DEC,2014,INTERNATIONAL FLIGHTS,42,44,86
7,DEC,2014,INTERNATIONAL FLIGHTS,45,44,89
8,DEC,2014,INTERNATIONAL FLIGHTS,41,39,80
9,DEC,2014,INTERNATIONAL FLIGHTS,38,42,80
10,DEC,2014,INTERNATIONAL FLIGHTS,47,39,86
11,DEC,2014,INTERNATIONAL FLIGHTS,39,42,81
12,DEC,2014,INTERNATIONAL FLIGHTS,39,41,80
13,DEC,2014,INTERNATIONAL FLIGHTS,48,43,91
14,DEC,2014,INTERNATIONAL FLIGHTS,46,49,95
15,DEC,2014,INTERNATIONAL FLIGHTS,42,39,81
16,DEC,2014,INTERNATIONAL FLIGHTS,35,37,72
17,DEC,2014,INTERNATIONAL FLIGHTS,42,43,85
18,DEC,2014,INTERNATIONAL FLIGHTS,40,37,77
19,DEC,2014,INTERNATIONAL FLIGHTS,48,39,87
20,DEC,2014,INTERNATIONAL FLIGHTS,48,52,100
21,DEC,2014,INTERNATIONAL FLIGHTS,50,48,98
22,DEC,2014,INTERNATIONAL FLIGHTS,42,44,86
23,DEC,2014,INTERNATIONAL FLIGHTS,37,39,76
24,DEC,2014,INTERNATIONAL FLIGHTS,36,38,74
25,DEC,2014,INTERNATIONAL FLIGHTS,26,26,52
26,DEC,2014,INTERNATIONAL FLIGHTS,33,31,64
27,DEC,2014,INTERNATIONAL FLIGHTS,44,47,91
28,DEC,2014,INTERNATIONAL FLIGHTS,48,41,89
29,DEC,2014,INTERNATIONAL FLIGHTS,42,46,88
30,DEC,2014,INTERNATIONAL FLIGHTS,39,41,80
31,DEC,2014,INTERNATIONAL FLIGHTS,36,37,73
1,DEC,2014,LOCAL FLIGHTS,5,5,10
2,DEC,2014,LOCAL FLIGHTS,7,7,14
3,DEC,2014,LOCAL FLIGHTS,12,12,24
4,DEC,2014,LOCAL FLIGHTS,11,11,22
5,DEC,2014,LOCAL FLIGHTS,15,15,30
6,DEC,2014,LOCAL FLIGHTS,12,12,24
7,DEC,2014,LOCAL FLIGHTS,1,1,2
8,DEC,2014,LOCAL FLIGHTS,9,9,18
9,DEC,2014,LOCAL FLIGHTS,1,1,2
10,DEC,2014,LOCAL FLIGHTS,6,6,12
11,DEC,2014,LOCAL FLIGHTS,13,13,26
12,DEC,2014,LOCAL FLIGHTS,2,2,4
13,DEC,2014,LOCAL FLIGHTS,0,0,0
14,DEC,2014,LOCAL FLIGHTS,1,1,2
15,DEC,2014,LOCAL FLIGHTS,16,17,33
16,DEC,2014,LOCAL FLIGHTS,11,11,22
17,DEC,2014,LOCAL FLIGHTS,13,13,26
18,DEC,2014,LOCAL FLIGHTS,16,16,32
19,DEC,2014,LOCAL FLIGHTS,4,5,9
20,DEC,2014,LOCAL FLIGHTS,16,16,32
21,DEC,2014,LOCAL FLIGHTS,3,3,6
22,DEC,2014,LOCAL FLIGHTS,5,5,10
23,DEC,2014,LOCAL FLIGHTS,16,16,32
24,DEC,2014,LOCAL FLIGHTS,2,2,4
25,DEC,2014,LOCAL FLIGHTS,0,0,0
26,DEC,2014,LOCAL FLIGHTS,1,1,2
27,DEC,2014,LOCAL FLIGHTS,3,3,6
28,DEC,2014,LOCAL FLIGHTS,0,0,0
29,DEC,2014,LOCAL FLIGHTS,4,4,8
30,DEC,2014,LOCAL FLIGHTS,19,19,38
31,DEC,2014,LOCAL FLIGHTS,4,4,8
1,DEC,2014,HELICOPTER FLIGHTS,0,3,3
2,DEC,2014,HELICOPTER FLIGHTS,1,2,3
3,DEC,2014,HELICOPTER FLIGHTS,3,3,6
4,DEC,2014,HELICOPTER FLIGHTS,1,1,2
5,DEC,2014,HELICOPTER FLIGHTS,2,2,4
6,DEC,2014,HELICOPTER FLIGHTS,2,2,4
7,DEC,2014,HELICOPTER FLIGHTS,1,1,2
8,DEC,2014,HELICOPTER FLIGHTS,1,1,2
9,DEC,2014,HELICOPTER FLIGHTS,2,2,4
10,DEC,2014,HELICOPTER FLIGHTS,2,2,4
11,DEC,2014,HELICOPTER FLIGHTS,1,1,2
12,DEC,2014,HELICOPTER FLIGHTS,1,1,2
13,DEC,2014,HELICOPTER FLIGHTS,0,0,0
14,DEC,2014,HELICOPTER FLIGHTS,0,0,0
15,DEC,2014,HELICOPTER FLIGHTS,1,1,2
16,DEC,2014,HELICOPTER FLIGHTS,1,1,2
17,DEC,2014,HELICOPTER FLIGHTS,2,2,4
18,DEC,2014,HELICOPTER FLIGHTS,0,0,0
19,DEC,2014,HELICOPTER FLIGHTS,4,4,8
20,DEC,2014,HELICOPTER FLIGHTS,0,0,0
21,DEC,2014,HELICOPTER FLIGHTS,0,0,0
22,DEC,2014,HELICOPTER FLIGHTS,0,0,0
23,DEC,2014,HELICOPTER FLIGHTS,3,4,7
24,DEC,2014,HELICOPTER FLIGHTS,0,0,0
25,DEC,2014,HELICOPTER FLIGHTS,0,0,0
26,DEC,2014,HELICOPTER FLIGHTS,0,0,0
27,DEC,2014,HELICOPTER FLIGHTS,0,1,1
28,DEC,2014,HELICOPTER FLIGHTS,0,0,0
29,DEC,2014,HELICOPTER FLIGHTS,2,2,4
30,DEC,2014,HELICOPTER FLIGHTS,1,1,2
31,DEC,2014,HELICOPTER FLIGHTS,1,1,2
