DAY,MONTH,YEAR,FLIGHT_CATEGORY,INBOUND_FLIGHTS,OUTBOUND_FLIGHTS,TOTAL_FLIGHTS
1,JAN,2016,INTERNATIONAL FLIGHTS,26,25,51
2,JAN,2016,INTERNATIONAL FLIGHTS,44,46,90
3,JAN,2016,INTERNATIONAL FLIGHTS,52,50,102
4,JAN,2016,INTERNATIONAL FLIGHTS,35,36,71
5,JAN,2016,INTERNATIONAL FLIGHTS,39,40,79
6,JAN,2016,INTERNATIONAL FLIGHTS,48,3,51
7,JAN,2016,INTERNATIONAL FLIGHTS,38,37,75
8,JAN,2016,INTERNATIONAL FLIGHTS,41,38,79
9,JAN,2016,INTERNATIONAL FLIGHTS,41,44,85
10,JAN,2016,INTERNATIONAL FLIGHTS,49,51,100
11,JAN,2016,INTERNATIONAL FLIGHTS,38,34,72
12,JAN,2016,INTERNATIONAL FLIGHTS,36,37,73
13,JAN,2016,INTERNATIONAL FLIGHTS,38,35,73
14,JAN,2016,INTERNATIONAL FLIGHTS,34,35,69
15,JAN,2016,INTERNATIONAL FLIGHTS,34,31,65
16,JAN,2016,INTERNATIONAL FLIGHTS,41,38,79
17,JAN,2016,INTERNATIONAL FLIGHTS,43,47,90
18,JAN,2016,INTERNATIONAL FLIGHTS,34,35,69
19,JAN,2016,INTERNATIONAL FLIGHTS,32,33,65
20,JAN,2016,INTERNATIONAL FLIGHTS,41,41,82
21,JAN,2016,INTERNATIONAL FLIGHTS,30,31,61
22,JAN,2016,INTERNATIONAL FLIGHTS,38,38,76
23,JAN,2016,INTERNATIONAL FLIGHTS,27,34,61
24,JAN,2016,INTERNATIONAL FLIGHTS,41,40,81
25,JAN,2016,INTERNATIONAL FLIGHTS,35,28,63
26,JAN,2016,INTERNATIONAL FLIGHTS,34,35,69
27,JAN,2016,INTERNATIONAL FLIGHTS,37,36,73
28,JAN,2016,INTERNATIONAL FLIGHTS,40,34,74
29,JAN,2016,INTERNATIONAL FLIGHTS,37,35,72
30,JAN,2016,INTERNATIONAL FLIGHTS,35,36,71
31,JAN,2016,INTERNATIONAL FLIGHTS,43,44,87
1,JAN,2016,LOCAL FLIGHTS,0,0,0
2,JAN,2016,LOCAL FLIGHTS,14,14,28
3,JAN,2016,LOCAL FLIGHTS,1,1,2
4,JAN,2016,LOCAL FLIGHTS,0,0,0
5,JAN,2016,LOCAL FLIGHTS,2,2,4
6,JAN,2016,LOCAL FLIGHTS,1,1,2
7,JAN,2016,LOCAL FLIGHTS,4,4,8
8,JAN,2016,LOCAL FLIGHTS,4,4,8
9,JAN,2016,LOCAL FLIGHTS,18,18,36
10,JAN,2016,LOCAL FLIGHTS,3,3,6
11,JAN,2016,LOCAL FLIGHTS,9,9,18
12,JAN,2016,LOCAL FLIGHTS,10,10,20
13,JAN,2016,LOCAL FLIGHTS,13,13,26
14,JAN,2016,LOCAL FLIGHTS,11,11,22
15,JAN,2016,LOCAL FLIGHTS,13,13,26
16,JAN,2016,LOCAL FLIGHTS,9,9,18
17,JAN,2016,LOCAL FLIGHTS,14,14,28
18,JAN,2016,LOCAL FLIGHTS,2,2,4
19,JAN,2016,LOCAL FLIGHTS,4,4,8
20,JAN,2016,LOCAL FLIGHTS,16,16,32
21,JAN,2016,LOCAL FLIGHTS,8,8,16
22,JAN,2016,LOCAL FLIGHTS,10,10,20
23,JAN,2016,LOCAL FLIGHTS,13,13,26
24,JAN,2016,LOCAL FLIGHTS,1,1,2
25,JAN,2016,LOCAL FLIGHTS,6,6,12
26,JAN,2016,LOCAL FLIGHTS,8,8,16
27,JAN,2016,LOCAL FLIGHTS,10,10,20
28,JAN,2016,LOCAL FLIGHTS,8,8,16
29,JAN,2016,LOCAL FLIGHTS,10,10,20
30,JAN,2016,LOCAL FLIGHTS,17,17,34
31,JAN,2016,LOCAL FLIGHTS,6,6,12
1,JAN,2016,HELICOPTER FLIGHTS,0,0,0
2,JAN,2016,HELICOPTER FLIGHTS,1,1,2
3,JAN,2016,HELICOPTER FLIGHTS,1,1,2
4,JAN,2016,HELICOPTER FLIGHTS,4,4,8
5,JAN,2016,HELICOPTER FLIGHTS,1,1,2
6,JAN,2016,HELICOPTER FLIGHTS,0,0,0
7,JAN,2016,HELICOPTER FLIGHTS,2,2,4
8,JAN,2016,HELICOPTER FLIGHTS,1,1,2
9,JAN,2016,HELICOPTER FLIGHTS,0,0,0
10,JAN,2016,HELICOPTER FLIGHTS,1,1,2
11,JAN,2016,HELICOPTER FLIGHTS,2,2,4
12,JAN,2016,HELICOPTER FLIGHTS,1,1,2
13,JAN,2016,HELICOPTER FLIGHTS,2,2,4
14,JAN,2016,HELICOPTER FLIGHTS,2,2,4
15,JAN,2016,HELICOPTER FLIGHTS,3,3,6
16,JAN,2016,HELICOPTER FLIGHTS,1,1,2
17,JAN,2016,HELICOPTER FLIGHTS,0,0,0
18,JAN,2016,HELICOPTER FLIGHTS,1,1,2
19,JAN,2016,HELICOPTER FLIGHTS,2,2,4
20,JAN,2016,HELICOPTER FLIGHTS,1,1,2
21,JAN,2016,HELICOPTER FLIGHTS,2,2,4
22,JAN,2016,HELICOPTER FLIGHTS,2,2,4
23,JAN,2016,HELICOPTER FLIGHTS,1,1,2
24,JAN,2016,HELICOPTER FLIGHTS,1,1,2
25,JAN,2016,HELICOPTER FLIGHTS,3,3,6
26,JAN,2016,HELICOPTER FLIGHTS,2,2,4
27,JAN,2016,HELICOPTER FLIGHTS,2,2,4
28,JAN,2016,HELICOPTER FLIGHTS,4,4,8
29,JAN,2016,HELICOPTER FLIGHTS,3,3,6
30,JAN,2016,HELICOPTER FLIGHTS,1,1,2
31,JAN,2016,HELICOPTER FLIGHTS,1,1,2
1,FEB,2016,INTERNATIONAL FLIGHTS,33,34,67
2,FEB,2016,INTERNATIONAL FLIGHTS,34,35,69
3,FEB,2016,INTERNATIONAL FLIGHTS,37,38,75
4,FEB,2016,INTERNATIONAL FLIGHTS,30,33,63
5,FEB,2016,INTERNATIONAL FLIGHTS,42,34,76
6,FEB,2016,INTERNATIONAL FLIGHTS,34,38,72
7,FEB,2016,INTERNATIONAL FLIGHTS,47,46,93
8,FEB,2016,INTERNATIONAL FLIGHTS,31,34,65
9,FEB,2016,INTERNATIONAL FLIGHTS,39,38,77
10,FEB,2016,INTERNATIONAL FLIGHTS,39,37,76
11,FEB,2016,INTERNATIONAL FLIGHTS,44,32,76
12,FEB,2016,INTERNATIONAL FLIGHTS,40,45,85
13,FEB,2016,INTERNATIONAL FLIGHTS,46,45,91
14,FEB,2016,INTERNATIONAL FLIGHTS,55,53,108
15,FEB,2016,INTERNATIONAL FLIGHTS,33,35,68
16,FEB,2016,INTERNATIONAL FLIGHTS,37,40,77
17,FEB,2016,INTERNATIONAL FLIGHTS,41,38,79
18,FEB,2016,INTERNATIONAL FLIGHTS,38,37,75
19,FEB,2016,INTERNATIONAL FLIGHTS,44,45,89
20,FEB,2016,INTERNATIONAL FLIGHTS,43,43,86
21,FEB,2016,INTERNATIONAL FLIGHTS,46,49,95
22,FEB,2016,INTERNATIONAL FLIGHTS,39,37,76
23,FEB,2016,INTERNATIONAL FLIGHTS,38,39,77
24,FEB,2016,INTERNATIONAL FLIGHTS,43,42,85
25,FEB,2016,INTERNATIONAL FLIGHTS,36,35,71
26,FEB,2016,INTERNATIONAL FLIGHTS,37,37,74
27,FEB,2016,INTERNATIONAL FLIGHTS,42,42,84
28,FEB,2016,INTERNATIONAL FLIGHTS,45,45,90
29,FEB,2016,INTERNATIONAL FLIGHTS,37,32,69
1,FEB,2016,LOCAL FLIGHTS,10,10,20
2,FEB,2016,LOCAL FLIGHTS,9,9,18
3,FEB,2016,LOCAL FLIGHTS,10,10,20
4,FEB,2016,LOCAL FLIGHTS,10,10,20
5,FEB,2016,LOCAL FLIGHTS,10,10,20
6,FEB,2016,LOCAL FLIGHTS,0,0,0
7,FEB,2016,LOCAL FLIGHTS,9,9,18
8,FEB,2016,LOCAL FLIGHTS,5,5,10
9,FEB,2016,LOCAL FLIGHTS,10,10,20
10,FEB,2016,LOCAL FLIGHTS,6,6,12
11,FEB,2016,LOCAL FLIGHTS,8,8,16
12,FEB,2016,LOCAL FLIGHTS,9,9,18
13,FEB,2016,LOCAL FLIGHTS,11,11,22
14,FEB,2016,LOCAL FLIGHTS,7,7,14
15,FEB,2016,LOCAL FLIGHTS,10,10,20
16,FEB,2016,LOCAL FLIGHTS,16,16,32
17,FEB,2016,LOCAL FLIGHTS,19,19,38
18,FEB,2016,LOCAL FLIGHTS,16,16,32
19,FEB,2016,LOCAL FLIGHTS,10,10,20
20,FEB,2016,LOCAL FLIGHTS,24,24,48
21,FEB,2016,LOCAL FLIGHTS,3,3,6
22,FEB,2016,LOCAL FLIGHTS,1,1,2
23,FEB,2016,LOCAL FLIGHTS,5,5,10
24,FEB,2016,LOCAL FLIGHTS,8,8,16
25,FEB,2016,LOCAL FLIGHTS,5,5,10
26,FEB,2016,LOCAL FLIGHTS,5,5,10
27,FEB,2016,LOCAL FLIGHTS,9,9,18
28,FEB,2016,LOCAL FLIGHTS,8,8,16
29,FEB,2016,LOCAL FLIGHTS,11,11,22
1,FEB,2016,HELICOPTER FLIGHTS,1,1,2
2,FEB,2016,HELICOPTER FLIGHTS,2,2,4
3,FEB,2016,HELICOPTER FLIGHTS,1,1,2
4,FEB,2016,HELICOPTER FLIGHTS,6,6,12
5,FEB,2016,HELICOPTER FLIGHTS,2,2,4
6,FEB,2016,HELICOPTER FLIGHTS,0,0,0
7,FEB,2016,HELICOPTER FLIGHTS,0,0,0
8,FEB,2016,HELICOPTER FLIGHTS,1,1,2
9,FEB,2016,HELICOPTER FLIGHTS,1,1,2
10,FEB,2016,HELICOPTER FLIGHTS,0,0,0
11,FEB,2016,HELICOPTER FLIGHTS,0,0,0
12,FEB,2016,HELICOPTER FLIGHTS,2,3,5
13,FEB,2016,HELICOPTER FLIGHTS,1,1,2
14,FEB,2016,HELICOPTER FLIGHTS,1,1,2
15,FEB,2016,HELICOPTER FLIGHTS,1,1,2
16,FEB,2016,HELICOPTER FLIGHTS,2,2,4
17,FEB,2016,HELICOPTER FLIGHTS,2,2,4
18,FEB,2016,HELICOPTER FLIGHTS,2,2,4
19,FEB,2016,HELICOPTER FLIGHTS,2,2,4
20,FEB,2016,HELICOPTER FLIGHTS,1,1,2
21,FEB,2016,HELICOPTER FLIGHTS,0,0,0
22,FEB,2016,HELICOPTER FLIGHTS,2,2,4
23,FEB,2016,HELICOPTER FLIGHTS,1,1,2
24,FEB,2016,HELICOPTER FLIGHTS,0,0,0
25,FEB,2016,HELICOPTER FLIGHTS,2,2,4
26,FEB,2016,HELICOPTER FLIGHTS,2,2,4
27,FEB,2016,HELICOPTER FLIGHTS,0,0,0
28,FEB,2016,HELICOPTER FLIGHTS,2,2,4
29,FEB,2016,HELICOPTER FLIGHTS,0,0,0
1,MAR,2016,INTERNATIONAL FLIGHTS,37,42,79
2,MAR,2016,INTERNATIONAL FLIGHTS,40,36,76
3,MAR,2016,INTERNATIONAL FLIGHTS,42,38,80
4,MAR,2016,INTERNATIONAL FLIGHTS,41,34,75
5,MAR,2016,INTERNATIONAL FLIGHTS,45,55,100
6,MAR,2016,INTERNATIONAL FLIGHTS,44,44,88
7,MAR,2016,INTERNATIONAL FLIGHTS,37,37,74
8,MAR,2016,INTERNATIONAL FLIGHTS,36,41,77
9,MAR,2016,INTERNATIONAL FLIGHTS,40,37,77
10,MAR,2016,INTERNATIONAL FLIGHTS,37,41,78
11,MAR,2016,INTERNATIONAL FLIGHTS,52,42,94
12,MAR,2016,INTERNATIONAL FLIGHTS,48,53,101
13,MAR,2016,INTERNATIONAL FLIGHTS,50,48,98
14,MAR,2016,INTERNATIONAL FLIGHTS,35,39,74
15,MAR,2016,INTERNATIONAL FLIGHTS,39,39,78
16,MAR,2016,INTERNATIONAL FLIGHTS,48,52,100
17,MAR,2016,INTERNATIONAL FLIGHTS,40,37,77
18,MAR,2016,INTERNATIONAL FLIGHTS,52,47,99
19,MAR,2016,INTERNATIONAL FLIGHTS,49,46,95
20,MAR,2016,INTERNATIONAL FLIGHTS,48,53,101
21,MAR,2016,INTERNATIONAL FLIGHTS,37,36,73
22,MAR,2016,INTERNATIONAL FLIGHTS,39,45,84
23,MAR,2016,INTERNATIONAL FLIGHTS,62,60,122
24,MAR,2016,INTERNATIONAL FLIGHTS,52,52,104
25,MAR,2016,INTERNATIONAL FLIGHTS,52,46,98
26,MAR,2016,INTERNATIONAL FLIGHTS,47,49,96
27,MAR,2016,INTERNATIONAL FLIGHTS,61,58,119
28,MAR,2016,INTERNATIONAL FLIGHTS,52,51,103
29,MAR,2016,INTERNATIONAL FLIGHTS,25,28,53
30,MAR,2016,INTERNATIONAL FLIGHTS,68,69,137
31,MAR,2016,INTERNATIONAL FLIGHTS,50,48,98
1,MAR,2016,LOCAL FLIGHTS,11,11,22
2,MAR,2016,LOCAL FLIGHTS,16,16,32
3,MAR,2016,LOCAL FLIGHTS,1,1,2
4,MAR,2016,LOCAL FLIGHTS,0,0,0
5,MAR,2016,LOCAL FLIGHTS,1,1,2
6,MAR,2016,LOCAL FLIGHTS,5,5,10
7,MAR,2016,LOCAL FLIGHTS,12,12,24
8,MAR,2016,LOCAL FLIGHTS,13,13,26
9,MAR,2016,LOCAL FLIGHTS,12,12,24
10,MAR,2016,LOCAL FLIGHTS,4,4,8
11,MAR,2016,LOCAL FLIGHTS,11,11,22
12,MAR,2016,LOCAL FLIGHTS,21,21,42
13,MAR,2016,LOCAL FLIGHTS,9,9,18
14,MAR,2016,LOCAL FLIGHTS,2,2,4
15,MAR,2016,LOCAL FLIGHTS,3,3,6
16,MAR,2016,LOCAL FLIGHTS,7,7,14
17,MAR,2016,LOCAL FLIGHTS,18,18,36
18,MAR,2016,LOCAL FLIGHTS,9,9,18
19,MAR,2016,LOCAL FLIGHTS,17,17,34
20,MAR,2016,LOCAL FLIGHTS,6,6,12
21,MAR,2016,LOCAL FLIGHTS,12,12,24
22,MAR,2016,LOCAL FLIGHTS,8,8,16
23,MAR,2016,LOCAL FLIGHTS,19,19,38
24,MAR,2016,LOCAL FLIGHTS,5,5,10
25,MAR,2016,LOCAL FLIGHTS,1,1,2
26,MAR,2016,LOCAL FLIGHTS,8,8,16
27,MAR,2016,LOCAL FLIGHTS,2,2,4
28,MAR,2016,LOCAL FLIGHTS,3,3,6
29,MAR,2016,LOCAL FLIGHTS,0,0,0
30,MAR,2016,LOCAL FLIGHTS,13,13,26
31,MAR,2016,LOCAL FLIGHTS,12,11,23
1,MAR,2016,HELICOPTER FLIGHTS,4,4,8
2,MAR,2016,HELICOPTER FLIGHTS,1,1,2
3,MAR,2016,HELICOPTER FLIGHTS,0,0,0
4,MAR,2016,HELICOPTER FLIGHTS,2,2,4
5,MAR,2016,HELICOPTER FLIGHTS,2,2,4
6,MAR,2016,HELICOPTER FLIGHTS,1,1,2
7,MAR,2016,HELICOPTER FLIGHTS,2,2,4
8,MAR,2016,HELICOPTER FLIGHTS,2,2,4
9,MAR,2016,HELICOPTER FLIGHTS,2,2,4
10,MAR,2016,HELICOPTER FLIGHTS,2,2,4
11,MAR,2016,HELICOPTER FLIGHTS,2,2,4
12,MAR,2016,HELICOPTER FLIGHTS,1,1,2
13,MAR,2016,HELICOPTER FLIGHTS,1,1,2
14,MAR,2016,HELICOPTER FLIGHTS,0,0,0
15,MAR,2016,HELICOPTER FLIGHTS,1,1,2
16,MAR,2016,HELICOPTER FLIGHTS,0,0,0
17,MAR,2016,HELICOPTER FLIGHTS,1,1,2
18,MAR,2016,HELICOPTER FLIGHTS,1,1,2
19,MAR,2016,HELICOPTER FLIGHTS,0,0,0
20,MAR,2016,HELICOPTER FLIGHTS,1,1,2
21,MAR,2016,HELICOPTER FLIGHTS,1,1,2
22,MAR,2016,HELICOPTER FLIGHTS,2,2,4
23,MAR,2016,HELICOPTER FLIGHTS,2,2,4
24,MAR,2016,HELICOPTER FLIGHTS,2,2,4
25,MAR,2016,HELICOPTER FLIGHTS,0,0,0
26,MAR,2016,HELICOPTER FLIGHTS,2,2,4
27,MAR,2016,HELICOPTER FLIGHTS,0,0,0
28,MAR,2016,HELICOPTER FLIGHTS,1,1,2
29,MAR,2016,HELICOPTER FLIGHTS,1,1,2
30,MAR,2016,HELICOPTER FLIGHTS,0,0,0
31,MAR,2016,HELICOPTER FLIGHTS,1,1,2
1,APR,2016,INTERNATIONAL FLIGHTS,62,59,121
2,APR,2016,INTERNATIONAL FLIGHTS,55,60,115
3,APR,2016,INTERNATIONAL FLIGHTS,69,64,133
4,APR,2016,INTERNATIONAL FLIGHTS,51,48,99
5,APR,2016,INTERNATIONAL FLIGHTS,50,45,95
6,APR,2016,INTERNATIONAL FLIGHTS,58,63,121
7,APR,2016,INTERNATIONAL FLIGHTS,42,41,83
8,APR,2016,INTERNATIONAL FLIGHTS,62,67,129
9,APR,2016,INTERNATIONAL FLIGHTS,62,60,122
10,APR,2016,INTERNATIONAL FLIGHTS,57,60,117
11,APR,2016,INTERNATIONAL FLIGHTS,56,57,113
12,APR,2016,INTERNATIONAL FLIGHTS,48,49,97
13,APR,2016,INTERNATIONAL FLIGHTS,58,60,118
14,APR,2016,INTERNATIONAL FLIGHTS,55,54,109
15,APR,2016,INTERNATIONAL FLIGHTS,63,60,123
16,APR,2016,INTERNATIONAL FLIGHTS,57,58,115
17,APR,2016,INTERNATIONAL FLIGHTS,67,69,136
18,APR,2016,INTERNATIONAL FLIGHTS,57,63,120
19,APR,2016,INTERNATIONAL FLIGHTS,44,47,91
20,APR,2016,INTERNATIONAL FLIGHTS,60,62,122
21,APR,2016,INTERNATIONAL FLIGHTS,55,52,107
22,APR,2016,INTERNATIONAL FLIGHTS,69,67,136
23,APR,2016,INTERNATIONAL FLIGHTS,63,67,130
24,APR,2016,INTERNATIONAL FLIGHTS,82,81,163
25,APR,2016,INTERNATIONAL FLIGHTS,73,74,147
26,APR,2016,INTERNATIONAL FLIGHTS,61,61,122
27,APR,2016,INTERNATIONAL FLIGHTS,84,79,163
28,APR,2016,INTERNATIONAL FLIGHTS,81,85,166
29,APR,2016,INTERNATIONAL FLIGHTS,83,85,168
30,APR,2016,INTERNATIONAL FLIGHTS,90,86,176
1,APR,2016,LOCAL FLIGHTS,3,3,6
2,APR,2016,LOCAL FLIGHTS,16,16,32
3,APR,2016,LOCAL FLIGHTS,3,3,6
4,APR,2016,LOCAL FLIGHTS,16,16,32
5,APR,2016,LOCAL FLIGHTS,16,17,33
6,APR,2016,LOCAL FLIGHTS,17,17,34
7,APR,2016,LOCAL FLIGHTS,17,17,34
8,APR,2016,LOCAL FLIGHTS,12,13,25
9,APR,2016,LOCAL FLIGHTS,20,20,40
10,APR,2016,LOCAL FLIGHTS,9,10,19
11,APR,2016,LOCAL FLIGHTS,15,15,30
12,APR,2016,LOCAL FLIGHTS,9,9,18
13,APR,2016,LOCAL FLIGHTS,20,20,40
14,APR,2016,LOCAL FLIGHTS,11,11,22
15,APR,2016,LOCAL FLIGHTS,18,18,36
16,APR,2016,LOCAL FLIGHTS,12,12,24
17,APR,2016,LOCAL FLIGHTS,9,9,18
18,APR,2016,LOCAL FLIGHTS,10,10,20
19,APR,2016,LOCAL FLIGHTS,14,14,28
20,APR,2016,LOCAL FLIGHTS,10,10,20
21,APR,2016,LOCAL FLIGHTS,14,14,28
22,APR,2016,LOCAL FLIGHTS,13,13,26
23,APR,2016,LOCAL FLIGHTS,13,13,26
24,APR,2016,LOCAL FLIGHTS,4,4,8
25,APR,2016,LOCAL FLIGHTS,12,13,25
26,APR,2016,LOCAL FLIGHTS,12,12,24
27,APR,2016,LOCAL FLIGHTS,11,11,22
28,APR,2016,LOCAL FLIGHTS,11,11,22
29,APR,2016,LOCAL FLIGHTS,5,5,10
30,APR,2016,LOCAL FLIGHTS,0,0,0
1,APR,2016,HELICOPTER FLIGHTS,0,0,0
2,APR,2016,HELICOPTER FLIGHTS,1,1,2
3,APR,2016,HELICOPTER FLIGHTS,1,1,2
4,APR,2016,HELICOPTER FLIGHTS,1,1,2
5,APR,2016,HELICOPTER FLIGHTS,2,2,4
6,APR,2016,HELICOPTER FLIGHTS,1,1,2
7,APR,2016,HELICOPTER FLIGHTS,1,1,2
8,APR,2016,HELICOPTER FLIGHTS,2,2,4
9,APR,2016,HELICOPTER FLIGHTS,1,1,2
10,APR,2016,HELICOPTER FLIGHTS,1,1,2
11,APR,2016,HELICOPTER FLIGHTS,1,1,2
12,APR,2016,HELICOPTER FLIGHTS,2,2,4
13,APR,2016,HELICOPTER FLIGHTS,4,4,8
14,APR,2016,HELICOPTER FLIGHTS,0,1,1
15,APR,2016,HELICOPTER FLIGHTS,2,2,4
16,APR,2016,HELICOPTER FLIGHTS,1,1,2
17,APR,2016,HELICOPTER FLIGHTS,1,1,2
18,APR,2016,HELICOPTER FLIGHTS,1,1,2
19,APR,2016,HELICOPTER FLIGHTS,1,1,2
20,APR,2016,HELICOPTER FLIGHTS,1,1,2
21,APR,2016,HELICOPTER FLIGHTS,1,1,2
22,APR,2016,HELICOPTER FLIGHTS,2,2,4
23,APR,2016,HELICOPTER FLIGHTS,1,1,2
24,APR,2016,HELICOPTER FLIGHTS,0,0,0
25,APR,2016,HELICOPTER FLIGHTS,0,0,0
26,APR,2016,HELICOPTER FLIGHTS,1,1,2
27,APR,2016,HELICOPTER FLIGHTS,0,0,0
28,APR,2016,HELICOPTER FLIGHTS,0,0,0
29,APR,2016,HELICOPTER FLIGHTS,0,0,0
30,APR,2016,HELICOPTER FLIGHTS,0,0,0
1,MAY,2016,INTERNATIONAL FLIGHTS,100,99,199
2,MAY,2016,INTERNATIONAL FLIGHTS,79,82,161
3,MAY,2016,INTERNATIONAL FLIGHTS,68,67,135
4,MAY,2016,INTERNATIONAL FLIGHTS,88,90,178
5,MAY,2016,INTERNATIONAL FLIGHTS,71,66,137
6,MAY,2016,INTERNATIONAL FLIGHTS,90,86,176
7,MAY,2016,INTERNATIONAL FLIGHTS,81,89,170
8,MAY,2016,INTERNATIONAL FLIGHTS,105,108,213
9,MAY,2016,INTERNATIONAL FLIGHTS,82,88,170
10,MAY,2016,INTERNATIONAL FLIGHTS,70,69,139
11,MAY,2016,INTERNATIONAL FLIGHTS,87,84,171
12,MAY,2016,INTERNATIONAL FLIGHTS,70,71,141
13,MAY,2016,INTERNATIONAL FLIGHTS,87,87,174
14,MAY,2016,INTERNATIONAL FLIGHTS,87,84,171
15,MAY,2016,INTERNATIONAL FLIGHTS,96,97,193
16,MAY,2016,INTERNATIONAL FLIGHTS,78,80,158
17,MAY,2016,INTERNATIONAL FLIGHTS,65,64,129
18,MAY,2016,INTERNATIONAL FLIGHTS,92,89,181
19,MAY,2016,INTERNATIONAL FLIGHTS,75,79,154
20,MAY,2016,INTERNATIONAL FLIGHTS,90,90,180
21,MAY,2016,INTERNATIONAL FLIGHTS,88,89,177
22,MAY,2016,INTERNATIONAL FLIGHTS,98,94,192
23,MAY,2016,INTERNATIONAL FLIGHTS,83,83,166
24,MAY,2016,INTERNATIONAL FLIGHTS,73,71,144
25,MAY,2016,INTERNATIONAL FLIGHTS,104,97,201
26,MAY,2016,INTERNATIONAL FLIGHTS,86,85,171
27,MAY,2016,INTERNATIONAL FLIGHTS,74,95,169
28,MAY,2016,INTERNATIONAL FLIGHTS,90,92,182
29,MAY,2016,INTERNATIONAL FLIGHTS,107,110,217
30,MAY,2016,INTERNATIONAL FLIGHTS,89,92,181
31,MAY,2016,INTERNATIONAL FLIGHTS,69,67,136
1,MAY,2016,LOCAL FLIGHTS,0,0,0
2,MAY,2016,LOCAL FLIGHTS,2,2,4
3,MAY,2016,LOCAL FLIGHTS,8,8,16
4,MAY,2016,LOCAL FLIGHTS,3,3,6
5,MAY,2016,LOCAL FLIGHTS,0,0,0
6,MAY,2016,LOCAL FLIGHTS,9,9,18
7,MAY,2016,LOCAL FLIGHTS,7,7,14
8,MAY,2016,LOCAL FLIGHTS,1,1,2
9,MAY,2016,LOCAL FLIGHTS,16,16,32
10,MAY,2016,LOCAL FLIGHTS,10,10,20
11,MAY,2016,LOCAL FLIGHTS,13,13,26
12,MAY,2016,LOCAL FLIGHTS,18,18,36
13,MAY,2016,LOCAL FLIGHTS,23,23,46
14,MAY,2016,LOCAL FLIGHTS,12,12,24
15,MAY,2016,LOCAL FLIGHTS,5,5,10
16,MAY,2016,LOCAL FLIGHTS,17,16,33
17,MAY,2016,LOCAL FLIGHTS,11,11,22
18,MAY,2016,LOCAL FLIGHTS,12,13,25
19,MAY,2016,LOCAL FLIGHTS,15,16,31
20,MAY,2016,LOCAL FLIGHTS,13,13,26
21,MAY,2016,LOCAL FLIGHTS,14,14,28
22,MAY,2016,LOCAL FLIGHTS,4,4,8
23,MAY,2016,LOCAL FLIGHTS,1,1,2
24,MAY,2016,LOCAL FLIGHTS,10,10,20
25,MAY,2016,LOCAL FLIGHTS,11,11,22
26,MAY,2016,LOCAL FLIGHTS,7,7,14
27,MAY,2016,LOCAL FLIGHTS,8,8,16
28,MAY,2016,LOCAL FLIGHTS,5,5,10
29,MAY,2016,LOCAL FLIGHTS,0,0,0
30,MAY,2016,LOCAL FLIGHTS,8,8,16
31,MAY,2016,LOCAL FLIGHTS,10,8,18
1,MAY,2016,HELICOPTER FLIGHTS,0,0,0
2,MAY,2016,HELICOPTER FLIGHTS,0,0,0
3,MAY,2016,HELICOPTER FLIGHTS,1,1,2
4,MAY,2016,HELICOPTER FLIGHTS,1,1,2
5,MAY,2016,HELICOPTER FLIGHTS,1,1,2
6,MAY,2016,HELICOPTER FLIGHTS,0,0,0
7,MAY,2016,HELICOPTER FLIGHTS,0,0,0
8,MAY,2016,HELICOPTER FLIGHTS,0,0,0
9,MAY,2016,HELICOPTER FLIGHTS,0,0,0
10,MAY,2016,HELICOPTER FLIGHTS,1,1,2
11,MAY,2016,HELICOPTER FLIGHTS,2,2,4
12,MAY,2016,HELICOPTER FLIGHTS,1,1,2
13,MAY,2016,HELICOPTER FLIGHTS,3,3,6
14,MAY,2016,HELICOPTER FLIGHTS,1,1,2
15,MAY,2016,HELICOPTER FLIGHTS,0,0,0
16,MAY,2016,HELICOPTER FLIGHTS,1,1,2
17,MAY,2016,HELICOPTER FLIGHTS,1,1,2
18,MAY,2016,HELICOPTER FLIGHTS,0,0,0
19,MAY,2016,HELICOPTER FLIGHTS,0,0,0
20,MAY,2016,HELICOPTER FLIGHTS,2,2,4
21,MAY,2016,HELICOPTER FLIGHTS,0,0,0
22,MAY,2016,HELICOPTER FLIGHTS,0,0,0
23,MAY,2016,HELICOPTER FLIGHTS,0,0,0
24,MAY,2016,HELICOPTER FLIGHTS,0,0,0
25,MAY,2016,HELICOPTER FLIGHTS,2,2,4
26,MAY,2016,HELICOPTER FLIGHTS,1,1,2
27,MAY,2016,HELICOPTER FLIGHTS,1,1,2
28,MAY,2016,HELICOPTER FLIGHTS,1,1,2
29,MAY,2016,HELICOPTER FLIGHTS,0,0,0
30,MAY,2016,HELICOPTER FLIGHTS,1,1,2
31,MAY,2016,HELICOPTER FLIGHTS,7,7,14
1,JUN,2016,INTERNATIONAL FLIGHTS,113,163,276
2,JUN,2016,INTERNATIONAL FLIGHTS,75,75,150
3,JUN,2016,INTERNATIONAL FLIGHTS,96,97,193
4,JUN,2016,INTERNATIONAL FLIGHTS,94,97,191
5,JUN,2016,INTERNATIONAL FLIGHTS,110,104,214
6,JUN,2016,INTERNATIONAL FLIGHTS,87,91,178
7,JUN,2016,INTERNATIONAL FLIGHTS,80,79,159
8,JUN,2016,INTERNATIONAL FLIGHTS,102,103,205
9,JUN,2016,INTERNATIONAL FLIGHTS,90,86,176
10,JUN,2016,INTERNATIONAL FLIGHTS,96,97,193
11,JUN,2016,INTERNATIONAL FLIGHTS,94,93,187
12,JUN,2016,INTERNATIONAL FLIGHTS,111,106,217
13,JUN,2016,INTERNATIONAL FLIGHTS,96,102,198
14,JUN,2016,INTERNATIONAL FLIGHTS,72,73,145
15,JUN,2016,INTERNATIONAL FLIGHTS,101,101,202
16,JUN,2016,INTERNATIONAL FLIGHTS,77,77,154
17,JUN,2016,INTERNATIONAL FLIGHTS,94,97,191
18,JUN,2016,INTERNATIONAL FLIGHTS,94,88,182
19,JUN,2016,INTERNATIONAL FLIGHTS,108,109,217
20,JUN,2016,INTERNATIONAL FLIGHTS,97,94,191
21,JUN,2016,INTERNATIONAL FLIGHTS,71,76,147
22,JUN,2016,INTERNATIONAL FLIGHTS,101,104,205
23,JUN,2016,INTERNATIONAL FLIGHTS,75,77,152
24,JUN,2016,INTERNATIONAL FLIGHTS,97,96,193
25,JUN,2016,INTERNATIONAL FLIGHTS,94,95,189
26,JUN,2016,INTERNATIONAL FLIGHTS,110,108,218
27,JUN,2016,INTERNATIONAL FLIGHTS,99,96,195
28,JUN,2016,INTERNATIONAL FLIGHTS,75,80,155
29,JUN,2016,INTERNATIONAL FLIGHTS,113,112,225
30,JUN,2016,INTERNATIONAL FLIGHTS,87,83,170
1,JUN,2016,LOCAL FLIGHTS,8,8,16
2,JUN,2016,LOCAL FLIGHTS,11,17,28
3,JUN,2016,LOCAL FLIGHTS,10,10,20
4,JUN,2016,LOCAL FLIGHTS,13,13,26
5,JUN,2016,LOCAL FLIGHTS,2,2,4
6,JUN,2016,LOCAL FLIGHTS,9,8,17
7,JUN,2016,LOCAL FLIGHTS,16,16,32
8,JUN,2016,LOCAL FLIGHTS,12,12,24
9,JUN,2016,LOCAL FLIGHTS,11,11,22
10,JUN,2016,LOCAL FLIGHTS,10,10,20
11,JUN,2016,LOCAL FLIGHTS,9,9,18
12,JUN,2016,LOCAL FLIGHTS,2,2,4
13,JUN,2016,LOCAL FLIGHTS,10,10,20
14,JUN,2016,LOCAL FLIGHTS,19,19,38
15,JUN,2016,LOCAL FLIGHTS,5,5,10
16,JUN,2016,LOCAL FLIGHTS,9,9,18
17,JUN,2016,LOCAL FLIGHTS,9,9,18
18,JUN,2016,LOCAL FLIGHTS,15,13,28
19,JUN,2016,LOCAL FLIGHTS,6,6,12
20,JUN,2016,LOCAL FLIGHTS,10,11,21
21,JUN,2016,LOCAL FLIGHTS,5,6,11
22,JUN,2016,LOCAL FLIGHTS,7,7,14
23,JUN,2016,LOCAL FLIGHTS,13,13,26
24,JUN,2016,LOCAL FLIGHTS,14,14,28
25,JUN,2016,LOCAL FLIGHTS,15,16,31
26,JUN,2016,LOCAL FLIGHTS,12,12,24
27,JUN,2016,LOCAL FLIGHTS,16,15,31
28,JUN,2016,LOCAL FLIGHTS,15,16,31
29,JUN,2016,LOCAL FLIGHTS,8,8,16
30,JUN,2016,LOCAL FLIGHTS,16,16,32
1,JUN,2016,HELICOPTER FLIGHTS,1,1,2
2,JUN,2016,HELICOPTER FLIGHTS,1,2,3
3,JUN,2016,HELICOPTER FLIGHTS,3,3,6
4,JUN,2016,HELICOPTER FLIGHTS,1,1,2
5,JUN,2016,HELICOPTER FLIGHTS,0,0,0
6,JUN,2016,HELICOPTER FLIGHTS,1,1,2
7,JUN,2016,HELICOPTER FLIGHTS,3,3,6
8,JUN,2016,HELICOPTER FLIGHTS,2,2,4
9,JUN,2016,HELICOPTER FLIGHTS,3,3,6
10,JUN,2016,HELICOPTER FLIGHTS,2,2,4
11,JUN,2016,HELICOPTER FLIGHTS,1,1,2
12,JUN,2016,HELICOPTER FLIGHTS,0,0,0
13,JUN,2016,HELICOPTER FLIGHTS,3,3,6
14,JUN,2016,HELICOPTER FLIGHTS,1,1,2
15,JUN,2016,HELICOPTER FLIGHTS,2,2,4
16,JUN,2016,HELICOPTER FLIGHTS,1,3,4
17,JUN,2016,HELICOPTER FLIGHTS,1,1,2
18,JUN,2016,HELICOPTER FLIGHTS,5,5,10
19,JUN,2016,HELICOPTER FLIGHTS,5,5,10
20,JUN,2016,HELICOPTER FLIGHTS,4,4,8
21,JUN,2016,HELICOPTER FLIGHTS,6,6,12
22,JUN,2016,HELICOPTER FLIGHTS,3,3,6
23,JUN,2016,HELICOPTER FLIGHTS,3,3,6
24,JUN,2016,HELICOPTER FLIGHTS,3,3,6
25,JUN,2016,HELICOPTER FLIGHTS,1,1,2
26,JUN,2016,HELICOPTER FLIGHTS,2,2,4
27,JUN,2016,HELICOPTER FLIGHTS,0,0,0
28,JUN,2016,HELICOPTER FLIGHTS,0,0,0
29,JUN,2016,HELICOPTER FLIGHTS,0,0,0
30,JUN,2016,HELICOPTER FLIGHTS,0,0,0
1,JUL,2016,INTERNATIONAL FLIGHTS,109,110,219
2,JUL,2016,INTERNATIONAL FLIGHTS,102,103,205
3,JUL,2016,INTERNATIONAL FLIGHTS,110,115,225
4,JUL,2016,INTERNATIONAL FLIGHTS,106,106,212
5,JUL,2016,INTERNATIONAL FLIGHTS,93,96,189
6,JUL,2016,INTERNATIONAL FLIGHTS,120,119,239
7,JUL,2016,INTERNATIONAL FLIGHTS,91,95,186
8,JUL,2016,INTERNATIONAL FLIGHTS,120,115,235
9,JUL,2016,INTERNATIONAL FLIGHTS,107,108,215
10,JUL,2016,INTERNATIONAL FLIGHTS,117,123,240
11,JUL,2016,INTERNATIONAL FLIGHTS,112,106,218
12,JUL,2016,INTERNATIONAL FLIGHTS,88,88,176
13,JUL,2016,INTERNATIONAL FLIGHTS,121,127,248
14,JUL,2016,INTERNATIONAL FLIGHTS,90,87,177
15,JUL,2016,INTERNATIONAL FLIGHTS,115,117,232
16,JUL,2016,INTERNATIONAL FLIGHTS,112,113,225
17,JUL,2016,INTERNATIONAL FLIGHTS,128,125,253
18,JUL,2016,INTERNATIONAL FLIGHTS,115,116,231
19,JUL,2016,INTERNATIONAL FLIGHTS,90,92,182
20,JUL,2016,INTERNATIONAL FLIGHTS,127,129,256
21,JUL,2016,INTERNATIONAL FLIGHTS,103,102,205
22,JUL,2016,INTERNATIONAL FLIGHTS,113,115,228
23,JUL,2016,INTERNATIONAL FLIGHTS,109,111,220
24,JUL,2016,INTERNATIONAL FLIGHTS,124,119,243
25,JUL,2016,INTERNATIONAL FLIGHTS,109,106,215
26,JUL,2016,INTERNATIONAL FLIGHTS,96,95,191
27,JUL,2016,INTERNATIONAL FLIGHTS,133,131,264
28,JUL,2016,INTERNATIONAL FLIGHTS,92,94,186
29,JUL,2016,INTERNATIONAL FLIGHTS,117,113,230
30,JUL,2016,INTERNATIONAL FLIGHTS,107,113,220
31,JUL,2016,INTERNATIONAL FLIGHTS,125,129,254
1,JUL,2016,LOCAL FLIGHTS,14,14,28
2,JUL,2016,LOCAL FLIGHTS,0,15,15
3,JUL,2016,LOCAL FLIGHTS,4,4,8
4,JUL,2016,LOCAL FLIGHTS,12,12,24
5,JUL,2016,LOCAL FLIGHTS,15,15,30
6,JUL,2016,LOCAL FLIGHTS,13,13,26
7,JUL,2016,LOCAL FLIGHTS,18,18,36
8,JUL,2016,LOCAL FLIGHTS,13,13,26
9,JUL,2016,LOCAL FLIGHTS,16,16,32
10,JUL,2016,LOCAL FLIGHTS,2,2,4
11,JUL,2016,LOCAL FLIGHTS,7,7,14
12,JUL,2016,LOCAL FLIGHTS,16,16,32
13,JUL,2016,LOCAL FLIGHTS,9,9,18
14,JUL,2016,LOCAL FLIGHTS,11,11,22
15,JUL,2016,LOCAL FLIGHTS,11,11,22
16,JUL,2016,LOCAL FLIGHTS,14,17,31
17,JUL,2016,LOCAL FLIGHTS,4,4,8
18,JUL,2016,LOCAL FLIGHTS,15,15,30
19,JUL,2016,LOCAL FLIGHTS,15,15,30
20,JUL,2016,LOCAL FLIGHTS,12,12,24
21,JUL,2016,LOCAL FLIGHTS,12,12,24
22,JUL,2016,LOCAL FLIGHTS,16,16,32
23,JUL,2016,LOCAL FLIGHTS,11,11,22
24,JUL,2016,LOCAL FLIGHTS,3,3,6
25,JUL,2016,LOCAL FLIGHTS,10,10,20
26,JUL,2016,LOCAL FLIGHTS,17,17,34
27,JUL,2016,LOCAL FLIGHTS,12,12,24
28,JUL,2016,LOCAL FLIGHTS,12,12,24
29,JUL,2016,LOCAL FLIGHTS,9,9,18
30,JUL,2016,LOCAL FLIGHTS,10,10,20
31,JUL,2016,LOCAL FLIGHTS,5,5,10
1,JUL,2016,HELICOPTER FLIGHTS,1,1,2
2,JUL,2016,HELICOPTER FLIGHTS,1,1,2
3,JUL,2016,HELICOPTER FLIGHTS,0,0,0
4,JUL,2016,HELICOPTER FLIGHTS,4,4,8
5,JUL,2016,HELICOPTER FLIGHTS,3,3,6
6,JUL,2016,HELICOPTER FLIGHTS,1,1,2
7,JUL,2016,HELICOPTER FLIGHTS,3,3,6
8,JUL,2016,HELICOPTER FLIGHTS,2,2,4
9,JUL,2016,HELICOPTER FLIGHTS,1,1,2
10,JUL,2016,HELICOPTER FLIGHTS,0,0,0
11,JUL,2016,HELICOPTER FLIGHTS,2,2,4
12,JUL,2016,HELICOPTER FLIGHTS,1,1,2
13,JUL,2016,HELICOPTER FLIGHTS,3,3,6
14,JUL,2016,HELICOPTER FLIGHTS,0,0,0
15,JUL,2016,HELICOPTER FLIGHTS,3,3,6
16,JUL,2016,HELICOPTER FLIGHTS,1,1,2
17,JUL,2016,HELICOPTER FLIGHTS,2,2,4
18,JUL,2016,HELICOPTER FLIGHTS,1,1,2
19,JUL,2016,HELICOPTER FLIGHTS,2,2,4
20,JUL,2016,HELICOPTER FLIGHTS,1,1,2
21,JUL,2016,HELICOPTER FLIGHTS,0,0,0
22,JUL,2016,HELICOPTER FLIGHTS,1,1,2
23,JUL,2016,HELICOPTER FLIGHTS,0,0,0
24,JUL,2016,HELICOPTER FLIGHTS,0,0,0
25,JUL,2016,HELICOPTER FLIGHTS,2,2,4
26,JUL,2016,HELICOPTER FLIGHTS,1,1,2
27,JUL,2016,HELICOPTER FLIGHTS,1,1,2
28,JUL,2016,HELICOPTER FLIGHTS,2,2,4
29,JUL,2016,HELICOPTER FLIGHTS,1,1,2
30,JUL,2016,HELICOPTER FLIGHTS,1,1,2
31,JUL,2016,HELICOPTER FLIGHTS,1,1,2
1,AUG,2016,INTERNATIONAL FLIGHTS,114,113,227
2,AUG,2016,INTERNATIONAL FLIGHTS,93,95,188
3,AUG,2016,INTERNATIONAL FLIGHTS,125,125,250
4,AUG,2016,INTERNATIONAL FLIGHTS,88,91,179
5,AUG,2016,INTERNATIONAL FLIGHTS,112,113,225
6,AUG,2016,INTERNATIONAL FLIGHTS,102,105,207
7,AUG,2016,INTERNATIONAL FLIGHTS,116,112,228
8,AUG,2016,INTERNATIONAL FLIGHTS,102,103,205
9,AUG,2016,INTERNATIONAL FLIGHTS,98,93,191
10,AUG,2016,INTERNATIONAL FLIGHTS,125,125,250
11,AUG,2016,INTERNATIONAL FLIGHTS,95,95,190
12,AUG,2016,INTERNATIONAL FLIGHTS,115,116,231
13,AUG,2016,INTERNATIONAL FLIGHTS,112,112,224
14,AUG,2016,INTERNATIONAL FLIGHTS,122,119,241
15,AUG,2016,INTERNATIONAL FLIGHTS,77,78,155
16,AUG,2016,INTERNATIONAL FLIGHTS,92,96,188
17,AUG,2016,INTERNATIONAL FLIGHTS,133,127,260
18,AUG,2016,INTERNATIONAL FLIGHTS,95,97,192
19,AUG,2016,INTERNATIONAL FLIGHTS,115,118,233
20,AUG,2016,INTERNATIONAL FLIGHTS,106,112,218
21,AUG,2016,INTERNATIONAL FLIGHTS,125,119,244
22,AUG,2016,INTERNATIONAL FLIGHTS,110,106,216
23,AUG,2016,INTERNATIONAL FLIGHTS,92,93,185
24,AUG,2016,INTERNATIONAL FLIGHTS,132,129,261
25,AUG,2016,INTERNATIONAL FLIGHTS,98,100,198
26,AUG,2016,INTERNATIONAL FLIGHTS,112,112,224
27,AUG,2016,INTERNATIONAL FLIGHTS,114,112,226
28,AUG,2016,INTERNATIONAL FLIGHTS,125,122,247
29,AUG,2016,INTERNATIONAL FLIGHTS,112,109,221
30,AUG,2016,INTERNATIONAL FLIGHTS,96,96,192
31,AUG,2016,INTERNATIONAL FLIGHTS,129,127,256
1,AUG,2016,LOCAL FLIGHTS,12,12,24
2,AUG,2016,LOCAL FLIGHTS,10,10,20
3,AUG,2016,LOCAL FLIGHTS,12,14,26
4,AUG,2016,LOCAL FLIGHTS,10,10,20
5,AUG,2016,LOCAL FLIGHTS,12,12,24
6,AUG,2016,LOCAL FLIGHTS,3,3,6
7,AUG,2016,LOCAL FLIGHTS,3,3,6
8,AUG,2016,LOCAL FLIGHTS,9,9,18
9,AUG,2016,LOCAL FLIGHTS,11,11,22
10,AUG,2016,LOCAL FLIGHTS,11,11,22
11,AUG,2016,LOCAL FLIGHTS,15,15,30
12,AUG,2016,LOCAL FLIGHTS,5,5,10
13,AUG,2016,LOCAL FLIGHTS,5,5,10
14,AUG,2016,LOCAL FLIGHTS,3,3,6
15,AUG,2016,LOCAL FLIGHTS,3,3,6
16,AUG,2016,LOCAL FLIGHTS,2,2,4
17,AUG,2016,LOCAL FLIGHTS,12,12,24
18,AUG,2016,LOCAL FLIGHTS,14,14,28
19,AUG,2016,LOCAL FLIGHTS,11,11,22
20,AUG,2016,LOCAL FLIGHTS,9,9,18
21,AUG,2016,LOCAL FLIGHTS,4,4,8
22,AUG,2016,LOCAL FLIGHTS,11,11,22
23,AUG,2016,LOCAL FLIGHTS,11,11,22
24,AUG,2016,LOCAL FLIGHTS,10,10,20
25,AUG,2016,LOCAL FLIGHTS,11,11,22
26,AUG,2016,LOCAL FLIGHTS,12,12,24
27,AUG,2016,LOCAL FLIGHTS,8,8,16
28,AUG,2016,LOCAL FLIGHTS,2,2,4
29,AUG,2016,LOCAL FLIGHTS,8,8,16
30,AUG,2016,LOCAL FLIGHTS,9,8,17
31,AUG,2016,LOCAL FLIGHTS,8,8,16
1,AUG,2016,HELICOPTER FLIGHTS,0,0,0
2,AUG,2016,HELICOPTER FLIGHTS,2,2,4
3,AUG,2016,HELICOPTER FLIGHTS,2,2,4
4,AUG,2016,HELICOPTER FLIGHTS,1,1,2
5,AUG,2016,HELICOPTER FLIGHTS,1,1,2
6,AUG,2016,HELICOPTER FLIGHTS,1,1,2
7,AUG,2016,HELICOPTER FLIGHTS,0,0,0
8,AUG,2016,HELICOPTER FLIGHTS,0,0,0
9,AUG,2016,HELICOPTER FLIGHTS,1,1,2
10,AUG,2016,HELICOPTER FLIGHTS,0,0,0
11,AUG,2016,HELICOPTER FLIGHTS,0,0,0
12,AUG,2016,HELICOPTER FLIGHTS,1,1,2
13,AUG,2016,HELICOPTER FLIGHTS,2,2,4
14,AUG,2016,HELICOPTER FLIGHTS,0,0,0
15,AUG,2016,HELICOPTER FLIGHTS,0,0,0
16,AUG,2016,HELICOPTER FLIGHTS,2,2,4
17,AUG,2016,HELICOPTER FLIGHTS,0,0,0
18,AUG,2016,HELICOPTER FLIGHTS,0,0,0
19,AUG,2016,HELICOPTER FLIGHTS,0,0,0
20,AUG,2016,HELICOPTER FLIGHTS,0,0,0
21,AUG,2016,HELICOPTER FLIGHTS,1,1,2
22,AUG,2016,HELICOPTER FLIGHTS,2,2,4
23,AUG,2016,HELICOPTER FLIGHTS,1,1,2
24,AUG,2016,HELICOPTER FLIGHTS,1,1,2
25,AUG,2016,HELICOPTER FLIGHTS,1,1,2
26,AUG,2016,HELICOPTER FLIGHTS,2,2,4
27,AUG,2016,HELICOPTER FLIGHTS,0,0,0
28,AUG,2016,HELICOPTER FLIGHTS,0,0,0
29,AUG,2016,HELICOPTER FLIGHTS,3,3,6
30,AUG,2016,HELICOPTER FLIGHTS,1,1,2
31,AUG,2016,HELICOPTER FLIGHTS,0,0,0
1,SEP,2016,INTERNATIONAL FLIGHTS,90,92,182
2,SEP,2016,INTERNATIONAL FLIGHTS,109,111,220
3,SEP,2016,INTERNATIONAL FLIGHTS,103,101,204
4,SEP,2016,INTERNATIONAL FLIGHTS,114,115,229
5,SEP,2016,INTERNATIONAL FLIGHTS,99,98,197
6,SEP,2016,INTERNATIONAL FLIGHTS,87,86,173
7,SEP,2016,INTERNATIONAL FLIGHTS,113,110,223
8,SEP,2016,INTERNATIONAL FLIGHTS,88,90,178
9,SEP,2016,INTERNATIONAL FLIGHTS,114,111,225
10,SEP,2016,INTERNATIONAL FLIGHTS,104,103,207
11,SEP,2016,INTERNATIONAL FLIGHTS,123,118,241
12,SEP,2016,INTERNATIONAL FLIGHTS,100,109,209
13,SEP,2016,INTERNATIONAL FLIGHTS,83,84,167
14,SEP,2016,INTERNATIONAL FLIGHTS,113,111,224
15,SEP,2016,INTERNATIONAL FLIGHTS,87,88,175
16,SEP,2016,INTERNATIONAL FLIGHTS,111,110,221
17,SEP,2016,INTERNATIONAL FLIGHTS,99,98,197
18,SEP,2016,INTERNATIONAL FLIGHTS,116,119,235
19,SEP,2016,INTERNATIONAL FLIGHTS,98,98,196
20,SEP,2016,INTERNATIONAL FLIGHTS,79,81,160
21,SEP,2016,INTERNATIONAL FLIGHTS,112,116,228
22,SEP,2016,INTERNATIONAL FLIGHTS,77,80,157
23,SEP,2016,INTERNATIONAL FLIGHTS,105,100,205
24,SEP,2016,INTERNATIONAL FLIGHTS,99,98,197
25,SEP,2016,INTERNATIONAL FLIGHTS,114,113,227
26,SEP,2016,INTERNATIONAL FLIGHTS,105,107,212
27,SEP,2016,INTERNATIONAL FLIGHTS,77,79,156
28,SEP,2016,INTERNATIONAL FLIGHTS,109,108,217
29,SEP,2016,INTERNATIONAL FLIGHTS,90,94,184
30,SEP,2016,INTERNATIONAL FLIGHTS,122,122,244
1,SEP,2016,LOCAL FLIGHTS,16,16,32
2,SEP,2016,LOCAL FLIGHTS,11,11,22
3,SEP,2016,LOCAL FLIGHTS,10,10,20
4,SEP,2016,LOCAL FLIGHTS,0,0,0
5,SEP,2016,LOCAL FLIGHTS,8,8,16
6,SEP,2016,LOCAL FLIGHTS,7,7,14
7,SEP,2016,LOCAL FLIGHTS,8,9,17
8,SEP,2016,LOCAL FLIGHTS,9,9,18
9,SEP,2016,LOCAL FLIGHTS,7,7,14
10,SEP,2016,LOCAL FLIGHTS,8,8,16
11,SEP,2016,LOCAL FLIGHTS,0,0,0
12,SEP,2016,LOCAL FLIGHTS,9,9,18
13,SEP,2016,LOCAL FLIGHTS,7,7,14
14,SEP,2016,LOCAL FLIGHTS,8,9,17
15,SEP,2016,LOCAL FLIGHTS,11,11,22
16,SEP,2016,LOCAL FLIGHTS,9,9,18
17,SEP,2016,LOCAL FLIGHTS,6,6,12
18,SEP,2016,LOCAL FLIGHTS,0,0,0
19,SEP,2016,LOCAL FLIGHTS,9,9,18
20,SEP,2016,LOCAL FLIGHTS,14,14,28
21,SEP,2016,LOCAL FLIGHTS,10,10,20
22,SEP,2016,LOCAL FLIGHTS,11,11,22
23,SEP,2016,LOCAL FLIGHTS,11,12,23
24,SEP,2016,LOCAL FLIGHTS,7,7,14
25,SEP,2016,LOCAL FLIGHTS,2,1,3
26,SEP,2016,LOCAL FLIGHTS,8,8,16
27,SEP,2016,LOCAL FLIGHTS,10,10,20
28,SEP,2016,LOCAL FLIGHTS,7,7,14
29,SEP,2016,LOCAL FLIGHTS,8,10,18
30,SEP,2016,LOCAL FLIGHTS,10,10,20
1,SEP,2016,HELICOPTER FLIGHTS,1,1,2
2,SEP,2016,HELICOPTER FLIGHTS,1,1,2
3,SEP,2016,HELICOPTER FLIGHTS,1,1,2
4,SEP,2016,HELICOPTER FLIGHTS,0,0,0
5,SEP,2016,HELICOPTER FLIGHTS,3,3,6
6,SEP,2016,HELICOPTER FLIGHTS,1,1,2
7,SEP,2016,HELICOPTER FLIGHTS,1,1,2
8,SEP,2016,HELICOPTER FLIGHTS,4,4,8
9,SEP,2016,HELICOPTER FLIGHTS,1,1,2
10,SEP,2016,HELICOPTER FLIGHTS,1,1,2
11,SEP,2016,HELICOPTER FLIGHTS,0,0,0
12,SEP,2016,HELICOPTER FLIGHTS,0,0,0
13,SEP,2016,HELICOPTER FLIGHTS,2,2,4
14,SEP,2016,HELICOPTER FLIGHTS,3,3,6
15,SEP,2016,HELICOPTER FLIGHTS,2,2,4
16,SEP,2016,HELICOPTER FLIGHTS,2,2,4
17,SEP,2016,HELICOPTER FLIGHTS,3,3,6
18,SEP,2016,HELICOPTER FLIGHTS,2,2,4
19,SEP,2016,HELICOPTER FLIGHTS,2,2,4
20,SEP,2016,HELICOPTER FLIGHTS,0,0,0
21,SEP,2016,HELICOPTER FLIGHTS,2,2,4
22,SEP,2016,HELICOPTER FLIGHTS,2,2,4
23,SEP,2016,HELICOPTER FLIGHTS,6,6,12
24,SEP,2016,HELICOPTER FLIGHTS,1,1,2
25,SEP,2016,HELICOPTER FLIGHTS,0,0,0
26,SEP,2016,HELICOPTER FLIGHTS,0,0,0
27,SEP,2016,HELICOPTER FLIGHTS,1,2,3
28,SEP,2016,HELICOPTER FLIGHTS,2,2,4
29,SEP,2016,HELICOPTER FLIGHTS,2,2,4
30,SEP,2016,HELICOPTER FLIGHTS,1,1,2
1,OCT,2016,INTERNATIONAL FLIGHTS,98,102,200
2,OCT,2016,INTERNATIONAL FLIGHTS,115,114,229
3,OCT,2016,INTERNATIONAL FLIGHTS,92,94,186
4,OCT,2016,INTERNATIONAL FLIGHTS,85,85,170
5,OCT,2016,INTERNATIONAL FLIGHTS,102,100,202
6,OCT,2016,INTERNATIONAL FLIGHTS,80,83,163
7,OCT,2016,INTERNATIONAL FLIGHTS,103,101,204
8,OCT,2016,INTERNATIONAL FLIGHTS,101,98,199
9,OCT,2016,INTERNATIONAL FLIGHTS,111,116,227
10,OCT,2016,INTERNATIONAL FLIGHTS,100,98,198
11,OCT,2016,INTERNATIONAL FLIGHTS,73,75,148
12,OCT,2016,INTERNATIONAL FLIGHTS,101,90,191
13,OCT,2016,INTERNATIONAL FLIGHTS,81,90,171
14,OCT,2016,INTERNATIONAL FLIGHTS,104,105,209
15,OCT,2016,INTERNATIONAL FLIGHTS,84,85,169
16,OCT,2016,INTERNATIONAL FLIGHTS,110,110,220
17,OCT,2016,INTERNATIONAL FLIGHTS,95,94,189
18,OCT,2016,INTERNATIONAL FLIGHTS,70,70,140
19,OCT,2016,INTERNATIONAL FLIGHTS,110,110,220
20,OCT,2016,INTERNATIONAL FLIGHTS,84,84,168
21,OCT,2016,INTERNATIONAL FLIGHTS,102,102,204
22,OCT,2016,INTERNATIONAL FLIGHTS,88,90,178
23,OCT,2016,INTERNATIONAL FLIGHTS,113,112,225
24,OCT,2016,INTERNATIONAL FLIGHTS,93,97,190
25,OCT,2016,INTERNATIONAL FLIGHTS,82,73,155
26,OCT,2016,INTERNATIONAL FLIGHTS,102,103,205
27,OCT,2016,INTERNATIONAL FLIGHTS,79,79,158
28,OCT,2016,INTERNATIONAL FLIGHTS,89,90,179
29,OCT,2016,INTERNATIONAL FLIGHTS,85,82,167
30,OCT,2016,INTERNATIONAL FLIGHTS,97,107,204
31,OCT,2016,INTERNATIONAL FLIGHTS,67,60,127
1,OCT,2016,LOCAL FLIGHTS,7,7,14
2,OCT,2016,LOCAL FLIGHTS,2,2,4
3,OCT,2016,LOCAL FLIGHTS,11,11,22
4,OCT,2016,LOCAL FLIGHTS,14,14,28
5,OCT,2016,LOCAL FLIGHTS,14,14,28
6,OCT,2016,LOCAL FLIGHTS,20,19,39
7,OCT,2016,LOCAL FLIGHTS,11,11,22
8,OCT,2016,LOCAL FLIGHTS,13,13,26
9,OCT,2016,LOCAL FLIGHTS,3,3,6
10,OCT,2016,LOCAL FLIGHTS,14,14,28
11,OCT,2016,LOCAL FLIGHTS,11,11,22
12,OCT,2016,LOCAL FLIGHTS,17,17,34
13,OCT,2016,LOCAL FLIGHTS,7,7,14
14,OCT,2016,LOCAL FLIGHTS,8,8,16
15,OCT,2016,LOCAL FLIGHTS,16,17,33
16,OCT,2016,LOCAL FLIGHTS,6,6,12
17,OCT,2016,LOCAL FLIGHTS,12,12,24
18,OCT,2016,LOCAL FLIGHTS,14,14,28
19,OCT,2016,LOCAL FLIGHTS,13,13,26
20,OCT,2016,LOCAL FLIGHTS,15,14,29
21,OCT,2016,LOCAL FLIGHTS,13,13,26
22,OCT,2016,LOCAL FLIGHTS,19,19,38
23,OCT,2016,LOCAL FLIGHTS,9,9,18
24,OCT,2016,LOCAL FLIGHTS,14,14,28
25,OCT,2016,LOCAL FLIGHTS,9,9,18
26,OCT,2016,LOCAL FLIGHTS,10,10,20
27,OCT,2016,LOCAL FLIGHTS,11,11,22
28,OCT,2016,LOCAL FLIGHTS,2,1,3
29,OCT,2016,LOCAL FLIGHTS,15,15,30
30,OCT,2016,LOCAL FLIGHTS,5,5,10
31,OCT,2016,LOCAL FLIGHTS,3,3,6
1,OCT,2016,HELICOPTER FLIGHTS,1,1,2
2,OCT,2016,HELICOPTER FLIGHTS,3,2,5
3,OCT,2016,HELICOPTER FLIGHTS,2,2,4
4,OCT,2016,HELICOPTER FLIGHTS,3,3,6
5,OCT,2016,HELICOPTER FLIGHTS,3,3,6
6,OCT,2016,HELICOPTER FLIGHTS,0,0,0
7,OCT,2016,HELICOPTER FLIGHTS,2,2,4
8,OCT,2016,HELICOPTER FLIGHTS,3,3,6
9,OCT,2016,HELICOPTER FLIGHTS,0,0,0
10,OCT,2016,HELICOPTER FLIGHTS,2,3,5
11,OCT,2016,HELICOPTER FLIGHTS,2,2,4
12,OCT,2016,HELICOPTER FLIGHTS,2,2,4
13,OCT,2016,HELICOPTER FLIGHTS,2,2,4
14,OCT,2016,HELICOPTER FLIGHTS,1,1,2
15,OCT,2016,HELICOPTER FLIGHTS,1,0,1
16,OCT,2016,HELICOPTER FLIGHTS,1,1,2
17,OCT,2016,HELICOPTER FLIGHTS,1,1,2
18,OCT,2016,HELICOPTER FLIGHTS,1,0,1
19,OCT,2016,HELICOPTER FLIGHTS,0,0,0
20,OCT,2016,HELICOPTER FLIGHTS,1,1,2
21,OCT,2016,HELICOPTER FLIGHTS,0,0,0
22,OCT,2016,HELICOPTER FLIGHTS,0,0,0
23,OCT,2016,HELICOPTER FLIGHTS,0,0,0
24,OCT,2016,HELICOPTER FLIGHTS,0,0,0
25,OCT,2016,HELICOPTER FLIGHTS,1,1,2
26,OCT,2016,HELICOPTER FLIGHTS,2,2,4
27,OCT,2016,HELICOPTER FLIGHTS,1,1,2
28,OCT,2016,HELICOPTER FLIGHTS,0,0,0
29,OCT,2016,HELICOPTER FLIGHTS,1,1,2
30,OCT,2016,HELICOPTER FLIGHTS,2,2,4
31,OCT,2016,HELICOPTER FLIGHTS,1,1,2
1,NOV,2016,INTERNATIONAL FLIGHTS,59,62,121
2,NOV,2016,INTERNATIONAL FLIGHTS,68,63,131
3,NOV,2016,INTERNATIONAL FLIGHTS,62,61,123
4,NOV,2016,INTERNATIONAL FLIGHTS,61,64,125
5,NOV,2016,INTERNATIONAL FLIGHTS,63,63,126
6,NOV,2016,INTERNATIONAL FLIGHTS,68,75,143
7,NOV,2016,INTERNATIONAL FLIGHTS,61,59,120
8,NOV,2016,INTERNATIONAL FLIGHTS,57,57,114
9,NOV,2016,INTERNATIONAL FLIGHTS,73,66,139
10,NOV,2016,INTERNATIONAL FLIGHTS,56,63,119
11,NOV,2016,INTERNATIONAL FLIGHTS,57,53,110
12,NOV,2016,INTERNATIONAL FLIGHTS,63,66,129
13,NOV,2016,INTERNATIONAL FLIGHTS,64,67,131
14,NOV,2016,INTERNATIONAL FLIGHTS,51,54,105
15,NOV,2016,INTERNATIONAL FLIGHTS,53,53,106
16,NOV,2016,INTERNATIONAL FLIGHTS,54,52,106
17,NOV,2016,INTERNATIONAL FLIGHTS,55,55,110
18,NOV,2016,INTERNATIONAL FLIGHTS,58,58,116
19,NOV,2016,INTERNATIONAL FLIGHTS,60,62,122
20,NOV,2016,INTERNATIONAL FLIGHTS,63,62,125
21,NOV,2016,INTERNATIONAL FLIGHTS,51,51,102
22,NOV,2016,INTERNATIONAL FLIGHTS,54,55,109
23,NOV,2016,INTERNATIONAL FLIGHTS,51,50,101
24,NOV,2016,INTERNATIONAL FLIGHTS,51,53,104
25,NOV,2016,INTERNATIONAL FLIGHTS,50,50,100
26,NOV,2016,INTERNATIONAL FLIGHTS,59,59,118
27,NOV,2016,INTERNATIONAL FLIGHTS,60,62,122
28,NOV,2016,INTERNATIONAL FLIGHTS,54,51,105
29,NOV,2016,INTERNATIONAL FLIGHTS,48,48,96
30,NOV,2016,INTERNATIONAL FLIGHTS,56,50,106
1,NOV,2016,LOCAL FLIGHTS,0,0,0
2,NOV,2016,LOCAL FLIGHTS,16,16,32
3,NOV,2016,LOCAL FLIGHTS,18,17,35
4,NOV,2016,LOCAL FLIGHTS,13,12,25
5,NOV,2016,LOCAL FLIGHTS,12,12,24
6,NOV,2016,LOCAL FLIGHTS,2,2,4
7,NOV,2016,LOCAL FLIGHTS,11,11,22
8,NOV,2016,LOCAL FLIGHTS,13,13,26
9,NOV,2016,LOCAL FLIGHTS,12,12,24
10,NOV,2016,LOCAL FLIGHTS,8,7,15
11,NOV,2016,LOCAL FLIGHTS,10,10,20
12,NOV,2016,LOCAL FLIGHTS,9,9,18
13,NOV,2016,LOCAL FLIGHTS,1,1,2
14,NOV,2016,LOCAL FLIGHTS,8,8,16
15,NOV,2016,LOCAL FLIGHTS,17,17,34
16,NOV,2016,LOCAL FLIGHTS,11,11,22
17,NOV,2016,LOCAL FLIGHTS,9,9,18
18,NOV,2016,LOCAL FLIGHTS,10,10,20
19,NOV,2016,LOCAL FLIGHTS,9,9,18
20,NOV,2016,LOCAL FLIGHTS,1,1,2
21,NOV,2016,LOCAL FLIGHTS,13,13,26
22,NOV,2016,LOCAL FLIGHTS,10,11,21
23,NOV,2016,LOCAL FLIGHTS,11,11,22
24,NOV,2016,LOCAL FLIGHTS,8,8,16
25,NOV,2016,LOCAL FLIGHTS,9,9,18
26,NOV,2016,LOCAL FLIGHTS,7,7,14
27,NOV,2016,LOCAL FLIGHTS,1,1,2
28,NOV,2016,LOCAL FLIGHTS,11,11,22
29,NOV,2016,LOCAL FLIGHTS,6,7,13
30,NOV,2016,LOCAL FLIGHTS,2,2,4
1,NOV,2016,HELICOPTER FLIGHTS,1,1,2
2,NOV,2016,HELICOPTER FLIGHTS,1,1,2
3,NOV,2016,HELICOPTER FLIGHTS,1,0,1
4,NOV,2016,HELICOPTER FLIGHTS,1,1,2
5,NOV,2016,HELICOPTER FLIGHTS,1,2,3
6,NOV,2016,HELICOPTER FLIGHTS,1,1,2
7,NOV,2016,HELICOPTER FLIGHTS,0,0,0
8,NOV,2016,HELICOPTER FLIGHTS,2,2,4
9,NOV,2016,HELICOPTER FLIGHTS,2,2,4
10,NOV,2016,HELICOPTER FLIGHTS,1,1,2
11,NOV,2016,HELICOPTER FLIGHTS,1,1,2
12,NOV,2016,HELICOPTER FLIGHTS,1,1,2
13,NOV,2016,HELICOPTER FLIGHTS,1,1,2
14,NOV,2016,HELICOPTER FLIGHTS,2,2,4
15,NOV,2016,HELICOPTER FLIGHTS,4,4,8
16,NOV,2016,HELICOPTER FLIGHTS,1,1,2
17,NOV,2016,HELICOPTER FLIGHTS,1,1,2
18,NOV,2016,HELICOPTER FLIGHTS,2,2,4
19,NOV,2016,HELICOPTER FLIGHTS,0,0,0
20,NOV,2016,HELICOPTER FLIGHTS,0,0,0
21,NOV,2016,HELICOPTER FLIGHTS,4,4,8
22,NOV,2016,HELICOPTER FLIGHTS,0,0,0
23,NOV,2016,HELICOPTER FLIGHTS,4,4,8
24,NOV,2016,HELICOPTER FLIGHTS,1,1,2
25,NOV,2016,HELICOPTER FLIGHTS,2,2,4
26,NOV,2016,HELICOPTER FLIGHTS,1,1,2
27,NOV,2016,HELICOPTER FLIGHTS,0,0,0
28,NOV,2016,HELICOPTER FLIGHTS,1,1,2
29,NOV,2016,HELICOPTER FLIGHTS,0,1,1
30,NOV,2016,HELICOPTER FLIGHTS,4,2,6
1,DEC,2016,INTERNATIONAL FLIGHTS,50,52,102
2,DEC,2016,INTERNATIONAL FLIGHTS,51,50,101
3,DEC,2016,INTERNATIONAL FLIGHTS,56,58,114
4,DEC,2016,INTERNATIONAL FLIGHTS,59,61,120
5,DEC,2016,INTERNATIONAL FLIGHTS,47,47,94
6,DEC,2016,INTERNATIONAL FLIGHTS,50,53,103
7,DEC,2016,INTERNATIONAL FLIGHTS,57,49,106
8,DEC,2016,INTERNATIONAL FLIGHTS,52,54,106
9,DEC,2016,INTERNATIONAL FLIGHTS,56,53,109
10,DEC,2016,INTERNATIONAL FLIGHTS,56,61,117
11,DEC,2016,INTERNATIONAL FLIGHTS,61,65,126
12,DEC,2016,INTERNATIONAL FLIGHTS,48,49,97
13,DEC,2016,INTERNATIONAL FLIGHTS,53,52,105
14,DEC,2016,INTERNATIONAL FLIGHTS,56,51,107
15,DEC,2016,INTERNATIONAL FLIGHTS,49,55,104
16,DEC,2016,INTERNATIONAL FLIGHTS,58,48,106
17,DEC,2016,INTERNATIONAL FLIGHTS,56,60,116
18,DEC,2016,INTERNATIONAL FLIGHTS,58,56,114
19,DEC,2016,INTERNATIONAL FLIGHTS,54,56,110
20,DEC,2016,INTERNATIONAL FLIGHTS,56,61,117
21,DEC,2016,INTERNATIONAL FLIGHTS,61,63,124
22,DEC,2016,INTERNATIONAL FLIGHTS,59,61,120
23,DEC,2016,INTERNATIONAL FLIGHTS,54,55,109
24,DEC,2016,INTERNATIONAL FLIGHTS,54,50,104
25,DEC,2016,INTERNATIONAL FLIGHTS,39,38,77
26,DEC,2016,INTERNATIONAL FLIGHTS,45,46,91
27,DEC,2016,INTERNATIONAL FLIGHTS,59,58,117
28,DEC,2016,INTERNATIONAL FLIGHTS,54,51,105
29,DEC,2016,INTERNATIONAL FLIGHTS,55,53,108
30,DEC,2016,INTERNATIONAL FLIGHTS,51,55,106
31,DEC,2016,INTERNATIONAL FLIGHTS,48,49,97
1,DEC,2016,LOCAL FLIGHTS,0,0,0
2,DEC,2016,LOCAL FLIGHTS,4,4,8
3,DEC,2016,LOCAL FLIGHTS,7,7,14
4,DEC,2016,LOCAL FLIGHTS,3,3,6
5,DEC,2016,LOCAL FLIGHTS,3,3,6
6,DEC,2016,LOCAL FLIGHTS,9,9,18
7,DEC,2016,LOCAL FLIGHTS,10,10,20
8,DEC,2016,LOCAL FLIGHTS,3,3,6
9,DEC,2016,LOCAL FLIGHTS,4,11,15
10,DEC,2016,LOCAL FLIGHTS,10,10,20
11,DEC,2016,LOCAL FLIGHTS,8,2,10
12,DEC,2016,LOCAL FLIGHTS,9,9,18
13,DEC,2016,LOCAL FLIGHTS,4,4,8
14,DEC,2016,LOCAL FLIGHTS,2,2,4
15,DEC,2016,LOCAL FLIGHTS,8,8,16
16,DEC,2016,LOCAL FLIGHTS,2,2,4
17,DEC,2016,LOCAL FLIGHTS,2,3,5
18,DEC,2016,LOCAL FLIGHTS,0,0,0
19,DEC,2016,LOCAL FLIGHTS,9,9,18
20,DEC,2016,LOCAL FLIGHTS,16,16,32
21,DEC,2016,LOCAL FLIGHTS,12,12,24
22,DEC,2016,LOCAL FLIGHTS,6,6,12
23,DEC,2016,LOCAL FLIGHTS,2,2,4
24,DEC,2016,LOCAL FLIGHTS,1,1,2
25,DEC,2016,LOCAL FLIGHTS,0,0,0
26,DEC,2016,LOCAL FLIGHTS,5,5,10
27,DEC,2016,LOCAL FLIGHTS,10,10,20
28,DEC,2016,LOCAL FLIGHTS,10,10,20
29,DEC,2016,LOCAL FLIGHTS,7,7,14
30,DEC,2016,LOCAL FLIGHTS,4,4,8
31,DEC,2016,LOCAL FLIGHTS,4,4,8
1,DEC,2016,HELICOPTER FLIGHTS,0,0,0
2,DEC,2016,HELICOPTER FLIGHTS,3,3,6
3,DEC,2016,HELICOPTER FLIGHTS,3,3,6
4,DEC,2016,HELICOPTER FLIGHTS,2,2,4
5,DEC,2016,HELICOPTER FLIGHTS,1,1,2
6,DEC,2016,HELICOPTER FLIGHTS,3,3,6
7,DEC,2016,HELICOPTER FLIGHTS,2,2,4
8,DEC,2016,HELICOPTER FLIGHTS,1,2,3
9,DEC,2016,HELICOPTER FLIGHTS,10,10,20
10,DEC,2016,HELICOPTER FLIGHTS,0,0,0
11,DEC,2016,HELICOPTER FLIGHTS,1,1,2
12,DEC,2016,HELICOPTER FLIGHTS,2,2,4
13,DEC,2016,HELICOPTER FLIGHTS,1,1,2
14,DEC,2016,HELICOPTER FLIGHTS,1,1,2
15,DEC,2016,HELICOPTER FLIGHTS,0,0,0
16,DEC,2016,HELICOPTER FLIGHTS,0,0,0
17,DEC,2016,HELICOPTER FLIGHTS,1,1,2
18,DEC,2016,HELICOPTER FLIGHTS,0,0,0
19,DEC,2016,HELICOPTER FLIGHTS,1,1,2
20,DEC,2016,HELICOPTER FLIGHTS,0,0,0
21,DEC,2016,HELICOPTER FLIGHTS,0,0,0
22,DEC,2016,HELICOPTER FLIGHTS,1,1,2
23,DEC,2016,HELICOPTER FLIGHTS,0,0,0
24,DEC,2016,HELICOPTER FLIGHTS,0,0,0
25,DEC,2016,HELICOPTER FLIGHTS,0,0,0
26,DEC,2016,HELICOPTER FLIGHTS,0,0,0
27,DEC,2016,HELICOPTER FLIGHTS,1,1,2
28,DEC,2016,HELICOPTER FLIGHTS,0,2,2
29,DEC,2016,HELICOPTER FLIGHTS,0,0,0
30,DEC,2016,HELICOPTER FLIGHTS,1,1,2
31,DEC,2016,HELICOPTER FLIGHTS,0,0,0
