DAY,MONTH,YEAR,FLIGHT_CATEGORY,INBOUND_FLIGHTS,OUTBOUND_FLIGHTS,TOTAL_FLIGHTS
1,JAN,2016,INTERNATIONAL FLIGHTS,6,6,12
2,JAN,2016,INTERNATIONAL FLIGHTS,15,13,28
3,JAN,2016,INTERNATIONAL FLIGHTS,17,17,34
4,JAN,2016,INTERNATIONAL FLIGHTS,10,9,19
5,JAN,2016,INTERNATIONAL FLIGHTS,9,9,18
6,JAN,2016,INTERNATIONAL FLIGHTS,17,18,35
7,JAN,2016,INTERNATIONAL FLIGHTS,8,10,18
8,JAN,2016,INTERNATIONAL FLIGHTS,7,6,13
9,JAN,2016,INTERNATIONAL FLIGHTS,10,11,21
10,JAN,2016,INTERNATIONAL FLIGHTS,12,12,24
11,JAN,2016,INTERNATIONAL FLIGHTS,6,8,14
12,JAN,2016,INTERNATIONAL FLIGHTS,6,6,12
13,JAN,2016,INTERNATIONAL FLIGHTS,10,12,22
14,JAN,2016,INTERNATIONAL FLIGHTS,5,5,10
15,JAN,2016,INTERNATIONAL FLIGHTS,9,8,17
16,JAN,2016,INTERNATIONAL FLIGHTS,10,11,21
17,JAN,2016,INTERNATIONAL FLIGHTS,10,12,22
18,JAN,2016,INTERNATIONAL FLIGHTS,11,6,17
19,JAN,2016,INTERNATIONAL FLIGHTS,4,7,11
20,JAN,2016,INTERNATIONAL FLIGHTS,10,10,20
21,JAN,2016,INTERNATIONAL FLIGHTS,5,6,11
22,JAN,2016,INTERNATIONAL FLIGHTS,8,7,15
23,JAN,2016,INTERNATIONAL FLIGHTS,9,8,17
24,JAN,2016,INTERNATIONAL FLIGHTS,10,10,20
25,JAN,2016,INTERNATIONAL FLIGHTS,7,7,14
26,JAN,2016,INTERNATIONAL FLIGHTS,5,6,11
27,JAN,2016,INTERNATIONAL FLIGHTS,8,8,16
28,JAN,2016,INTERNATIONAL FLIGHTS,7,4,11
29,JAN,2016,INTERNATIONAL FLIGHTS,8,10,18
30,JAN,2016,INTERNATIONAL FLIGHTS,11,9,20
31,JAN,2016,INTERNATIONAL FLIGHTS,14,12,26
1,JAN,2016,LOCAL FLIGHTS,0,0,0
2,JAN,2016,LOCAL FLIGHTS,3,3,6
3,JAN,2016,LOCAL FLIGHTS,0,0,0
4,JAN,2016,LOCAL FLIGHTS,2,2,4
5,JAN,2016,LOCAL FLIGHTS,0,0,0
6,JAN,2016,LOCAL FLIGHTS,0,0,0
7,JAN,2016,LOCAL FLIGHTS,0,0,0
8,JAN,2016,LOCAL FLIGHTS,0,0,0
9,JAN,2016,LOCAL FLIGHTS,1,1,2
10,JAN,2016,LOCAL FLIGHTS,0,0,0
11,JAN,2016,LOCAL FLIGHTS,0,0,0
12,JAN,2016,LOCAL FLIGHTS,0,0,0
13,JAN,2016,LOCAL FLIGHTS,1,1,2
14,JAN,2016,LOCAL FLIGHTS,2,2,4
15,JAN,2016,LOCAL FLIGHTS,1,1,2
16,JAN,2016,LOCAL FLIGHTS,3,3,6
17,JAN,2016,LOCAL FLIGHTS,0,0,0
18,JAN,2016,LOCAL FLIGHTS,1,2,3
19,JAN,2016,LOCAL FLIGHTS,0,0,0
20,JAN,2016,LOCAL FLIGHTS,3,2,5
21,JAN,2016,LOCAL FLIGHTS,2,3,5
22,JAN,2016,LOCAL FLIGHTS,1,1,2
23,JAN,2016,LOCAL FLIGHTS,3,3,6
24,JAN,2016,LOCAL FLIGHTS,0,0,0
25,JAN,2016,LOCAL FLIGHTS,1,1,2
26,JAN,2016,LOCAL FLIGHTS,1,1,2
27,JAN,2016,LOCAL FLIGHTS,0,0,0
28,JAN,2016,LOCAL FLIGHTS,1,1,2
29,JAN,2016,LOCAL FLIGHTS,1,1,2
30,JAN,2016,LOCAL FLIGHTS,4,4,8
31,JAN,2016,LOCAL FLIGHTS,1,1,2
1,JAN,2016,HELICOPTER FLIGHTS,0,0,0
2,JAN,2016,HELICOPTER FLIGHTS,0,0,0
3,JAN,2016,HELICOPTER FLIGHTS,0,0,0
4,JAN,2016,HELICOPTER FLIGHTS,1,1,2
5,JAN,2016,HELICOPTER FLIGHTS,1,1,2
6,JAN,2016,HELICOPTER FLIGHTS,0,0,0
7,JAN,2016,HELICOPTER FLIGHTS,6,6,12
8,JAN,2016,HELICOPTER FLIGHTS,0,0,0
9,JAN,2016,HELICOPTER FLIGHTS,0,0,0
10,JAN,2016,HELICOPTER FLIGHTS,0,0,0
11,JAN,2016,HELICOPTER FLIGHTS,4,4,8
12,JAN,2016,HELICOPTER FLIGHTS,7,7,14
13,JAN,2016,HELICOPTER FLIGHTS,8,8,16
14,JAN,2016,HELICOPTER FLIGHTS,14,14,28
15,JAN,2016,HELICOPTER FLIGHTS,0,0,0
16,JAN,2016,HELICOPTER FLIGHTS,0,0,0
17,JAN,2016,HELICOPTER FLIGHTS,0,0,0
18,JAN,2016,HELICOPTER FLIGHTS,0,0,0
19,JAN,2016,HELICOPTER FLIGHTS,0,0,0
20,JAN,2016,HELICOPTER FLIGHTS,9,9,18
21,JAN,2016,HELICOPTER FLIGHTS,2,2,4
22,JAN,2016,HELICOPTER FLIGHTS,2,2,4
23,JAN,2016,HELICOPTER FLIGHTS,0,0,0
24,JAN,2016,HELICOPTER FLIGHTS,1,1,2
25,JAN,2016,HELICOPTER FLIGHTS,3,3,6
26,JAN,2016,HELICOPTER FLIGHTS,4,4,8
27,JAN,2016,HELICOPTER FLIGHTS,7,7,14
28,JAN,2016,HELICOPTER FLIGHTS,13,13,26
29,JAN,2016,HELICOPTER FLIGHTS,1,1,2
30,JAN,2016,HELICOPTER FLIGHTS,0,0,0
31,JAN,2016,HELICOPTER FLIGHTS,9,9,18
1,FEB,2016,INTERNATIONAL FLIGHTS,8,8,16
2,FEB,2016,INTERNATIONAL FLIGHTS,6,5,11
3,FEB,2016,INTERNATIONAL FLIGHTS,10,10,20
4,FEB,2016,INTERNATIONAL FLIGHTS,4,5,9
5,FEB,2016,INTERNATIONAL FLIGHTS,7,7,14
6,FEB,2016,INTERNATIONAL FLIGHTS,9,8,17
7,FEB,2016,INTERNATIONAL FLIGHTS,15,11,26
8,FEB,2016,INTERNATIONAL FLIGHTS,7,9,16
9,FEB,2016,INTERNATIONAL FLIGHTS,5,5,10
10,FEB,2016,INTERNATIONAL FLIGHTS,11,12,23
11,FEB,2016,INTERNATIONAL FLIGHTS,10,9,19
12,FEB,2016,INTERNATIONAL FLIGHTS,11,12,23
13,FEB,2016,INTERNATIONAL FLIGHTS,11,13,24
14,FEB,2016,INTERNATIONAL FLIGHTS,13,11,24
15,FEB,2016,INTERNATIONAL FLIGHTS,8,10,18
16,FEB,2016,INTERNATIONAL FLIGHTS,5,5,10
17,FEB,2016,INTERNATIONAL FLIGHTS,14,13,27
18,FEB,2016,INTERNATIONAL FLIGHTS,8,6,14
19,FEB,2016,INTERNATIONAL FLIGHTS,9,8,17
20,FEB,2016,INTERNATIONAL FLIGHTS,9,12,21
21,FEB,2016,INTERNATIONAL FLIGHTS,10,10,20
22,FEB,2016,INTERNATIONAL FLIGHTS,8,8,16
23,FEB,2016,INTERNATIONAL FLIGHTS,9,8,17
24,FEB,2016,INTERNATIONAL FLIGHTS,15,15,30
25,FEB,2016,INTERNATIONAL FLIGHTS,6,8,14
26,FEB,2016,INTERNATIONAL FLIGHTS,8,8,16
27,FEB,2016,INTERNATIONAL FLIGHTS,9,9,18
28,FEB,2016,INTERNATIONAL FLIGHTS,10,8,18
29,FEB,2016,INTERNATIONAL FLIGHTS,9,8,17
1,FEB,2016,LOCAL FLIGHTS,0,1,1
2,FEB,2016,LOCAL FLIGHTS,3,3,6
3,FEB,2016,LOCAL FLIGHTS,2,2,4
4,FEB,2016,LOCAL FLIGHTS,1,1,2
5,FEB,2016,LOCAL FLIGHTS,0,0,0
6,FEB,2016,LOCAL FLIGHTS,1,1,2
7,FEB,2016,LOCAL FLIGHTS,0,0,0
8,FEB,2016,LOCAL FLIGHTS,2,2,4
9,FEB,2016,LOCAL FLIGHTS,2,2,4
10,FEB,2016,LOCAL FLIGHTS,1,1,2
11,FEB,2016,LOCAL FLIGHTS,1,0,1
12,FEB,2016,LOCAL FLIGHTS,0,0,0
13,FEB,2016,LOCAL FLIGHTS,2,2,4
14,FEB,2016,LOCAL FLIGHTS,1,1,2
15,FEB,2016,LOCAL FLIGHTS,3,3,6
16,FEB,2016,LOCAL FLIGHTS,4,4,8
17,FEB,2016,LOCAL FLIGHTS,2,2,4
18,FEB,2016,LOCAL FLIGHTS,2,2,4
19,FEB,2016,LOCAL FLIGHTS,2,3,5
20,FEB,2016,LOCAL FLIGHTS,2,2,4
21,FEB,2016,LOCAL FLIGHTS,1,1,2
22,FEB,2016,LOCAL FLIGHTS,1,1,2
23,FEB,2016,LOCAL FLIGHTS,3,3,6
24,FEB,2016,LOCAL FLIGHTS,7,7,14
25,FEB,2016,LOCAL FLIGHTS,5,5,10
26,FEB,2016,LOCAL FLIGHTS,0,0,0
27,FEB,2016,LOCAL FLIGHTS,2,2,4
28,FEB,2016,LOCAL FLIGHTS,0,0,0
29,FEB,2016,LOCAL FLIGHTS,1,1,2
1,FEB,2016,HELICOPTER FLIGHTS,9,9,18
2,FEB,2016,HELICOPTER FLIGHTS,9,9,18
3,FEB,2016,HELICOPTER FLIGHTS,7,7,14
4,FEB,2016,HELICOPTER FLIGHTS,11,11,22
5,FEB,2016,HELICOPTER FLIGHTS,1,1,2
6,FEB,2016,HELICOPTER FLIGHTS,0,0,0
7,FEB,2016,HELICOPTER FLIGHTS,0,0,0
8,FEB,2016,HELICOPTER FLIGHTS,5,5,10
9,FEB,2016,HELICOPTER FLIGHTS,7,7,14
10,FEB,2016,HELICOPTER FLIGHTS,7,7,14
11,FEB,2016,HELICOPTER FLIGHTS,14,14,28
12,FEB,2016,HELICOPTER FLIGHTS,0,0,0
13,FEB,2016,HELICOPTER FLIGHTS,0,0,0
14,FEB,2016,HELICOPTER FLIGHTS,0,0,0
15,FEB,2016,HELICOPTER FLIGHTS,8,8,16
16,FEB,2016,HELICOPTER FLIGHTS,9,9,18
17,FEB,2016,HELICOPTER FLIGHTS,9,9,18
18,FEB,2016,HELICOPTER FLIGHTS,8,8,16
19,FEB,2016,HELICOPTER FLIGHTS,3,3,6
20,FEB,2016,HELICOPTER FLIGHTS,0,0,0
21,FEB,2016,HELICOPTER FLIGHTS,2,2,4
22,FEB,2016,HELICOPTER FLIGHTS,2,2,4
23,FEB,2016,HELICOPTER FLIGHTS,5,5,10
24,FEB,2016,HELICOPTER FLIGHTS,14,14,28
25,FEB,2016,HELICOPTER FLIGHTS,7,7,14
26,FEB,2016,HELICOPTER FLIGHTS,1,1,2
27,FEB,2016,HELICOPTER FLIGHTS,0,0,0
28,FEB,2016,HELICOPTER FLIGHTS,1,1,2
29,FEB,2016,HELICOPTER FLIGHTS,6,6,12
1,MAR,2016,INTERNATIONAL FLIGHTS,9,8,17
2,MAR,2016,INTERNATIONAL FLIGHTS,26,25,51
3,MAR,2016,INTERNATIONAL FLIGHTS,9,10,19
4,MAR,2016,INTERNATIONAL FLIGHTS,13,10,23
5,MAR,2016,INTERNATIONAL FLIGHTS,11,12,23
6,MAR,2016,INTERNATIONAL FLIGHTS,11,10,21
7,MAR,2016,INTERNATIONAL FLIGHTS,10,8,18
8,MAR,2016,INTERNATIONAL FLIGHTS,8,8,16
9,MAR,2016,INTERNATIONAL FLIGHTS,29,29,58
10,MAR,2016,INTERNATIONAL FLIGHTS,12,14,26
11,MAR,2016,INTERNATIONAL FLIGHTS,13,14,27
12,MAR,2016,INTERNATIONAL FLIGHTS,11,13,24
13,MAR,2016,INTERNATIONAL FLIGHTS,10,11,21
14,MAR,2016,INTERNATIONAL FLIGHTS,9,8,17
15,MAR,2016,INTERNATIONAL FLIGHTS,9,9,18
16,MAR,2016,INTERNATIONAL FLIGHTS,29,28,57
17,MAR,2016,INTERNATIONAL FLIGHTS,11,9,20
18,MAR,2016,INTERNATIONAL FLIGHTS,13,13,26
19,MAR,2016,INTERNATIONAL FLIGHTS,14,14,28
20,MAR,2016,INTERNATIONAL FLIGHTS,12,11,23
21,MAR,2016,INTERNATIONAL FLIGHTS,7,8,15
22,MAR,2016,INTERNATIONAL FLIGHTS,10,10,20
23,MAR,2016,INTERNATIONAL FLIGHTS,34,34,68
24,MAR,2016,INTERNATIONAL FLIGHTS,9,9,18
25,MAR,2016,INTERNATIONAL FLIGHTS,13,12,25
26,MAR,2016,INTERNATIONAL FLIGHTS,18,18,36
27,MAR,2016,INTERNATIONAL FLIGHTS,22,22,44
28,MAR,2016,INTERNATIONAL FLIGHTS,12,12,24
29,MAR,2016,INTERNATIONAL FLIGHTS,27,27,54
30,MAR,2016,INTERNATIONAL FLIGHTS,40,40,80
31,MAR,2016,INTERNATIONAL FLIGHTS,18,13,31
1,MAR,2016,LOCAL FLIGHTS,0,1,1
2,MAR,2016,LOCAL FLIGHTS,2,2,4
3,MAR,2016,LOCAL FLIGHTS,3,3,6
4,MAR,2016,LOCAL FLIGHTS,2,2,4
5,MAR,2016,LOCAL FLIGHTS,0,0,0
6,MAR,2016,LOCAL FLIGHTS,2,2,4
7,MAR,2016,LOCAL FLIGHTS,0,0,0
8,MAR,2016,LOCAL FLIGHTS,3,3,6
9,MAR,2016,LOCAL FLIGHTS,0,0,0
10,MAR,2016,LOCAL FLIGHTS,1,1,2
11,MAR,2016,LOCAL FLIGHTS,1,1,2
12,MAR,2016,LOCAL FLIGHTS,1,1,2
13,MAR,2016,LOCAL FLIGHTS,2,2,4
14,MAR,2016,LOCAL FLIGHTS,1,1,2
15,MAR,2016,LOCAL FLIGHTS,1,1,2
16,MAR,2016,LOCAL FLIGHTS,1,1,2
17,MAR,2016,LOCAL FLIGHTS,4,4,8
18,MAR,2016,LOCAL FLIGHTS,1,1,2
19,MAR,2016,LOCAL FLIGHTS,1,1,2
20,MAR,2016,LOCAL FLIGHTS,0,0,0
21,MAR,2016,LOCAL FLIGHTS,2,2,4
22,MAR,2016,LOCAL FLIGHTS,3,3,6
23,MAR,2016,LOCAL FLIGHTS,1,1,2
24,MAR,2016,LOCAL FLIGHTS,1,1,2
25,MAR,2016,LOCAL FLIGHTS,2,2,4
26,MAR,2016,LOCAL FLIGHTS,2,2,4
27,MAR,2016,LOCAL FLIGHTS,3,3,6
28,MAR,2016,LOCAL FLIGHTS,3,3,6
29,MAR,2016,LOCAL FLIGHTS,1,1,2
30,MAR,2016,LOCAL FLIGHTS,3,3,6
31,MAR,2016,LOCAL FLIGHTS,3,3,6
1,MAR,2016,HELICOPTER FLIGHTS,8,8,16
2,MAR,2016,HELICOPTER FLIGHTS,10,10,20
3,MAR,2016,HELICOPTER FLIGHTS,4,4,8
4,MAR,2016,HELICOPTER FLIGHTS,2,2,4
5,MAR,2016,HELICOPTER FLIGHTS,1,1,2
6,MAR,2016,HELICOPTER FLIGHTS,0,0,0
7,MAR,2016,HELICOPTER FLIGHTS,8,8,16
8,MAR,2016,HELICOPTER FLIGHTS,10,10,20
9,MAR,2016,HELICOPTER FLIGHTS,7,7,14
10,MAR,2016,HELICOPTER FLIGHTS,8,8,16
11,MAR,2016,HELICOPTER FLIGHTS,2,2,4
12,MAR,2016,HELICOPTER FLIGHTS,0,0,0
13,MAR,2016,HELICOPTER FLIGHTS,0,0,0
14,MAR,2016,HELICOPTER FLIGHTS,0,0,0
15,MAR,2016,HELICOPTER FLIGHTS,0,0,0
16,MAR,2016,HELICOPTER FLIGHTS,5,5,10
17,MAR,2016,HELICOPTER FLIGHTS,10,10,20
18,MAR,2016,HELICOPTER FLIGHTS,0,0,0
19,MAR,2016,HELICOPTER FLIGHTS,0,0,0
20,MAR,2016,HELICOPTER FLIGHTS,0,0,0
21,MAR,2016,HELICOPTER FLIGHTS,5,5,10
22,MAR,2016,HELICOPTER FLIGHTS,7,7,14
23,MAR,2016,HELICOPTER FLIGHTS,9,9,18
24,MAR,2016,HELICOPTER FLIGHTS,3,3,6
25,MAR,2016,HELICOPTER FLIGHTS,0,0,0
26,MAR,2016,HELICOPTER FLIGHTS,0,0,0
27,MAR,2016,HELICOPTER FLIGHTS,4,4,8
28,MAR,2016,HELICOPTER FLIGHTS,4,4,8
29,MAR,2016,HELICOPTER FLIGHTS,6,6,12
30,MAR,2016,HELICOPTER FLIGHTS,8,8,16
31,MAR,2016,HELICOPTER FLIGHTS,4,4,8
1,APR,2016,INTERNATIONAL FLIGHTS,17,19,36
2,APR,2016,INTERNATIONAL FLIGHTS,25,24,49
3,APR,2016,INTERNATIONAL FLIGHTS,24,25,49
4,APR,2016,INTERNATIONAL FLIGHTS,13,12,25
5,APR,2016,INTERNATIONAL FLIGHTS,15,13,28
6,APR,2016,INTERNATIONAL FLIGHTS,44,45,89
7,APR,2016,INTERNATIONAL FLIGHTS,11,11,22
8,APR,2016,INTERNATIONAL FLIGHTS,24,23,47
9,APR,2016,INTERNATIONAL FLIGHTS,22,21,43
10,APR,2016,INTERNATIONAL FLIGHTS,24,25,49
11,APR,2016,INTERNATIONAL FLIGHTS,15,16,31
12,APR,2016,INTERNATIONAL FLIGHTS,18,15,33
13,APR,2016,INTERNATIONAL FLIGHTS,45,46,91
14,APR,2016,INTERNATIONAL FLIGHTS,16,15,31
15,APR,2016,INTERNATIONAL FLIGHTS,18,19,37
16,APR,2016,INTERNATIONAL FLIGHTS,23,23,46
17,APR,2016,INTERNATIONAL FLIGHTS,27,26,53
18,APR,2016,INTERNATIONAL FLIGHTS,16,17,33
19,APR,2016,INTERNATIONAL FLIGHTS,14,13,27
20,APR,2016,INTERNATIONAL FLIGHTS,42,42,84
21,APR,2016,INTERNATIONAL FLIGHTS,17,17,34
22,APR,2016,INTERNATIONAL FLIGHTS,15,17,32
23,APR,2016,INTERNATIONAL FLIGHTS,21,22,43
24,APR,2016,INTERNATIONAL FLIGHTS,31,28,59
25,APR,2016,INTERNATIONAL FLIGHTS,15,16,31
26,APR,2016,INTERNATIONAL FLIGHTS,20,16,36
27,APR,2016,INTERNATIONAL FLIGHTS,49,49,98
28,APR,2016,INTERNATIONAL FLIGHTS,22,22,44
29,APR,2016,INTERNATIONAL FLIGHTS,26,27,53
30,APR,2016,INTERNATIONAL FLIGHTS,26,26,52
1,APR,2016,LOCAL FLIGHTS,2,2,4
2,APR,2016,LOCAL FLIGHTS,4,4,8
3,APR,2016,LOCAL FLIGHTS,0,0,0
4,APR,2016,LOCAL FLIGHTS,4,4,8
5,APR,2016,LOCAL FLIGHTS,1,1,2
6,APR,2016,LOCAL FLIGHTS,5,5,10
7,APR,2016,LOCAL FLIGHTS,5,4,9
8,APR,2016,LOCAL FLIGHTS,0,0,0
9,APR,2016,LOCAL FLIGHTS,3,3,6
10,APR,2016,LOCAL FLIGHTS,0,0,0
11,APR,2016,LOCAL FLIGHTS,0,0,0
12,APR,2016,LOCAL FLIGHTS,2,2,4
13,APR,2016,LOCAL FLIGHTS,2,2,4
14,APR,2016,LOCAL FLIGHTS,2,2,4
15,APR,2016,LOCAL FLIGHTS,2,2,4
16,APR,2016,LOCAL FLIGHTS,2,2,4
17,APR,2016,LOCAL FLIGHTS,2,2,4
18,APR,2016,LOCAL FLIGHTS,5,5,10
19,APR,2016,LOCAL FLIGHTS,2,2,4
20,APR,2016,LOCAL FLIGHTS,1,1,2
21,APR,2016,LOCAL FLIGHTS,3,3,6
22,APR,2016,LOCAL FLIGHTS,4,4,8
23,APR,2016,LOCAL FLIGHTS,2,2,4
24,APR,2016,LOCAL FLIGHTS,2,2,4
25,APR,2016,LOCAL FLIGHTS,3,3,6
26,APR,2016,LOCAL FLIGHTS,2,2,4
27,APR,2016,LOCAL FLIGHTS,2,2,4
28,APR,2016,LOCAL FLIGHTS,6,6,12
29,APR,2016,LOCAL FLIGHTS,2,2,4
30,APR,2016,LOCAL FLIGHTS,0,0,0
1,APR,2016,HELICOPTER FLIGHTS,0,0,0
2,APR,2016,HELICOPTER FLIGHTS,0,0,0
3,APR,2016,HELICOPTER FLIGHTS,0,0,0
4,APR,2016,HELICOPTER FLIGHTS,7,7,14
5,APR,2016,HELICOPTER FLIGHTS,3,3,6
6,APR,2016,HELICOPTER FLIGHTS,5,5,10
7,APR,2016,HELICOPTER FLIGHTS,5,5,10
8,APR,2016,HELICOPTER FLIGHTS,0,0,0
9,APR,2016,HELICOPTER FLIGHTS,0,0,0
10,APR,2016,HELICOPTER FLIGHTS,0,0,0
11,APR,2016,HELICOPTER FLIGHTS,8,8,16
12,APR,2016,HELICOPTER FLIGHTS,7,7,14
13,APR,2016,HELICOPTER FLIGHTS,6,6,12
14,APR,2016,HELICOPTER FLIGHTS,11,10,21
15,APR,2016,HELICOPTER FLIGHTS,2,2,4
16,APR,2016,HELICOPTER FLIGHTS,0,0,0
17,APR,2016,HELICOPTER FLIGHTS,0,0,0
18,APR,2016,HELICOPTER FLIGHTS,5,5,10
19,APR,2016,HELICOPTER FLIGHTS,11,11,22
20,APR,2016,HELICOPTER FLIGHTS,9,9,18
21,APR,2016,HELICOPTER FLIGHTS,11,11,22
22,APR,2016,HELICOPTER FLIGHTS,0,0,0
23,APR,2016,HELICOPTER FLIGHTS,0,0,0
24,APR,2016,HELICOPTER FLIGHTS,0,0,0
25,APR,2016,HELICOPTER FLIGHTS,1,2,3
26,APR,2016,HELICOPTER FLIGHTS,8,8,16
27,APR,2016,HELICOPTER FLIGHTS,2,2,4
28,APR,2016,HELICOPTER FLIGHTS,0,0,0
29,APR,2016,HELICOPTER FLIGHTS,0,0,0
30,APR,2016,HELICOPTER FLIGHTS,0,0,0
1,MAY,2016,INTERNATIONAL FLIGHTS,36,36,72
2,MAY,2016,INTERNATIONAL FLIGHTS,24,24,48
3,MAY,2016,INTERNATIONAL FLIGHTS,21,19,40
4,MAY,2016,INTERNATIONAL FLIGHTS,49,51,100
5,MAY,2016,INTERNATIONAL FLIGHTS,18,18,36
6,MAY,2016,INTERNATIONAL FLIGHTS,16,18,34
7,MAY,2016,INTERNATIONAL FLIGHTS,28,29,57
8,MAY,2016,INTERNATIONAL FLIGHTS,38,36,74
9,MAY,2016,INTERNATIONAL FLIGHTS,22,22,44
10,MAY,2016,INTERNATIONAL FLIGHTS,22,18,40
11,MAY,2016,INTERNATIONAL FLIGHTS,50,51,101
12,MAY,2016,INTERNATIONAL FLIGHTS,21,19,40
13,MAY,2016,INTERNATIONAL FLIGHTS,18,16,34
14,MAY,2016,INTERNATIONAL FLIGHTS,30,37,67
15,MAY,2016,INTERNATIONAL FLIGHTS,35,40,75
16,MAY,2016,INTERNATIONAL FLIGHTS,23,21,44
17,MAY,2016,INTERNATIONAL FLIGHTS,20,18,38
18,MAY,2016,INTERNATIONAL FLIGHTS,48,46,94
19,MAY,2016,INTERNATIONAL FLIGHTS,22,25,47
20,MAY,2016,INTERNATIONAL FLIGHTS,16,18,34
21,MAY,2016,INTERNATIONAL FLIGHTS,33,32,65
22,MAY,2016,INTERNATIONAL FLIGHTS,35,36,71
23,MAY,2016,INTERNATIONAL FLIGHTS,18,17,35
24,MAY,2016,INTERNATIONAL FLIGHTS,16,14,30
25,MAY,2016,INTERNATIONAL FLIGHTS,47,46,93
26,MAY,2016,INTERNATIONAL FLIGHTS,21,18,39
27,MAY,2016,INTERNATIONAL FLIGHTS,19,21,40
28,MAY,2016,INTERNATIONAL FLIGHTS,29,32,61
29,MAY,2016,INTERNATIONAL FLIGHTS,39,38,77
30,MAY,2016,INTERNATIONAL FLIGHTS,21,19,40
31,MAY,2016,INTERNATIONAL FLIGHTS,16,19,35
1,MAY,2016,LOCAL FLIGHTS,1,1,2
2,MAY,2016,LOCAL FLIGHTS,0,0,0
3,MAY,2016,LOCAL FLIGHTS,2,2,4
4,MAY,2016,LOCAL FLIGHTS,2,2,4
5,MAY,2016,LOCAL FLIGHTS,0,0,0
6,MAY,2016,LOCAL FLIGHTS,2,2,4
7,MAY,2016,LOCAL FLIGHTS,2,2,4
8,MAY,2016,LOCAL FLIGHTS,0,0,0
9,MAY,2016,LOCAL FLIGHTS,7,7,14
10,MAY,2016,LOCAL FLIGHTS,3,3,6
11,MAY,2016,LOCAL FLIGHTS,2,2,4
12,MAY,2016,LOCAL FLIGHTS,6,6,12
13,MAY,2016,LOCAL FLIGHTS,2,2,4
14,MAY,2016,LOCAL FLIGHTS,2,2,4
15,MAY,2016,LOCAL FLIGHTS,1,1,2
16,MAY,2016,LOCAL FLIGHTS,7,7,14
17,MAY,2016,LOCAL FLIGHTS,3,3,6
18,MAY,2016,LOCAL FLIGHTS,3,2,5
19,MAY,2016,LOCAL FLIGHTS,3,3,6
20,MAY,2016,LOCAL FLIGHTS,2,2,4
21,MAY,2016,LOCAL FLIGHTS,1,2,3
22,MAY,2016,LOCAL FLIGHTS,1,1,2
23,MAY,2016,LOCAL FLIGHTS,1,1,2
24,MAY,2016,LOCAL FLIGHTS,2,2,4
25,MAY,2016,LOCAL FLIGHTS,2,2,4
26,MAY,2016,LOCAL FLIGHTS,5,5,10
27,MAY,2016,LOCAL FLIGHTS,1,1,2
28,MAY,2016,LOCAL FLIGHTS,1,1,2
29,MAY,2016,LOCAL FLIGHTS,0,0,0
30,MAY,2016,LOCAL FLIGHTS,6,6,12
31,MAY,2016,LOCAL FLIGHTS,7,7,14
1,MAY,2016,HELICOPTER FLIGHTS,0,0,0
2,MAY,2016,HELICOPTER FLIGHTS,0,0,0
3,MAY,2016,HELICOPTER FLIGHTS,0,0,0
4,MAY,2016,HELICOPTER FLIGHTS,8,8,16
5,MAY,2016,HELICOPTER FLIGHTS,9,9,18
6,MAY,2016,HELICOPTER FLIGHTS,3,3,6
7,MAY,2016,HELICOPTER FLIGHTS,0,0,0
8,MAY,2016,HELICOPTER FLIGHTS,0,0,0
9,MAY,2016,HELICOPTER FLIGHTS,6,6,12
10,MAY,2016,HELICOPTER FLIGHTS,8,8,16
11,MAY,2016,HELICOPTER FLIGHTS,7,7,14
12,MAY,2016,HELICOPTER FLIGHTS,5,5,10
13,MAY,2016,HELICOPTER FLIGHTS,2,2,4
14,MAY,2016,HELICOPTER FLIGHTS,2,2,4
15,MAY,2016,HELICOPTER FLIGHTS,0,0,0
16,MAY,2016,HELICOPTER FLIGHTS,3,3,6
17,MAY,2016,HELICOPTER FLIGHTS,10,10,20
18,MAY,2016,HELICOPTER FLIGHTS,1,1,2
19,MAY,2016,HELICOPTER FLIGHTS,6,6,12
20,MAY,2016,HELICOPTER FLIGHTS,2,2,4
21,MAY,2016,HELICOPTER FLIGHTS,0,0,0
22,MAY,2016,HELICOPTER FLIGHTS,0,0,0
23,MAY,2016,HELICOPTER FLIGHTS,7,7,14
24,MAY,2016,HELICOPTER FLIGHTS,4,4,8
25,MAY,2016,HELICOPTER FLIGHTS,6,6,12
26,MAY,2016,HELICOPTER FLIGHTS,12,12,24
27,MAY,2016,HELICOPTER FLIGHTS,1,1,2
28,MAY,2016,HELICOPTER FLIGHTS,0,0,0
29,MAY,2016,HELICOPTER FLIGHTS,0,0,0
30,MAY,2016,HELICOPTER FLIGHTS,5,5,10
31,MAY,2016,HELICOPTER FLIGHTS,7,7,14
1,JUN,2016,INTERNATIONAL FLIGHTS,56,49,105
2,JUN,2016,INTERNATIONAL FLIGHTS,25,27,52
3,JUN,2016,INTERNATIONAL FLIGHTS,22,22,44
4,JUN,2016,INTERNATIONAL FLIGHTS,30,31,61
5,JUN,2016,INTERNATIONAL FLIGHTS,40,39,79
6,JUN,2016,INTERNATIONAL FLIGHTS,18,19,37
7,JUN,2016,INTERNATIONAL FLIGHTS,20,15,35
8,JUN,2016,INTERNATIONAL FLIGHTS,49,51,100
9,JUN,2016,INTERNATIONAL FLIGHTS,23,22,45
10,JUN,2016,INTERNATIONAL FLIGHTS,24,20,44
11,JUN,2016,INTERNATIONAL FLIGHTS,30,32,62
12,JUN,2016,INTERNATIONAL FLIGHTS,38,40,78
13,JUN,2016,INTERNATIONAL FLIGHTS,19,22,41
14,JUN,2016,INTERNATIONAL FLIGHTS,16,15,31
15,JUN,2016,INTERNATIONAL FLIGHTS,50,46,96
16,JUN,2016,INTERNATIONAL FLIGHTS,23,28,51
17,JUN,2016,INTERNATIONAL FLIGHTS,21,23,44
18,JUN,2016,INTERNATIONAL FLIGHTS,29,28,57
19,JUN,2016,INTERNATIONAL FLIGHTS,45,41,86
20,JUN,2016,INTERNATIONAL FLIGHTS,31,24,55
21,JUN,2016,INTERNATIONAL FLIGHTS,19,17,36
22,JUN,2016,INTERNATIONAL FLIGHTS,53,51,104
23,JUN,2016,INTERNATIONAL FLIGHTS,28,23,51
24,JUN,2016,INTERNATIONAL FLIGHTS,20,24,44
25,JUN,2016,INTERNATIONAL FLIGHTS,34,35,69
26,JUN,2016,INTERNATIONAL FLIGHTS,41,45,86
27,JUN,2016,INTERNATIONAL FLIGHTS,19,19,38
28,JUN,2016,INTERNATIONAL FLIGHTS,16,16,32
29,JUN,2016,INTERNATIONAL FLIGHTS,50,48,98
30,JUN,2016,INTERNATIONAL FLIGHTS,28,26,54
1,JUN,2016,LOCAL FLIGHTS,1,1,2
2,JUN,2016,LOCAL FLIGHTS,3,3,6
3,JUN,2016,LOCAL FLIGHTS,3,3,6
4,JUN,2016,LOCAL FLIGHTS,2,2,4
5,JUN,2016,LOCAL FLIGHTS,1,1,2
6,JUN,2016,LOCAL FLIGHTS,3,4,7
7,JUN,2016,LOCAL FLIGHTS,2,2,4
8,JUN,2016,LOCAL FLIGHTS,1,1,2
9,JUN,2016,LOCAL FLIGHTS,3,3,6
10,JUN,2016,LOCAL FLIGHTS,3,3,6
11,JUN,2016,LOCAL FLIGHTS,2,2,4
12,JUN,2016,LOCAL FLIGHTS,0,0,0
13,JUN,2016,LOCAL FLIGHTS,3,3,6
14,JUN,2016,LOCAL FLIGHTS,3,3,6
15,JUN,2016,LOCAL FLIGHTS,2,2,4
16,JUN,2016,LOCAL FLIGHTS,1,1,2
17,JUN,2016,LOCAL FLIGHTS,5,5,10
18,JUN,2016,LOCAL FLIGHTS,16,14,30
19,JUN,2016,LOCAL FLIGHTS,31,42,73
20,JUN,2016,LOCAL FLIGHTS,60,58,118
21,JUN,2016,LOCAL FLIGHTS,50,46,96
22,JUN,2016,LOCAL FLIGHTS,34,34,68
23,JUN,2016,LOCAL FLIGHTS,6,6,12
24,JUN,2016,LOCAL FLIGHTS,2,2,4
25,JUN,2016,LOCAL FLIGHTS,2,2,4
26,JUN,2016,LOCAL FLIGHTS,1,1,2
27,JUN,2016,LOCAL FLIGHTS,4,4,8
28,JUN,2016,LOCAL FLIGHTS,4,5,9
29,JUN,2016,LOCAL FLIGHTS,1,1,2
30,JUN,2016,LOCAL FLIGHTS,1,1,2
1,JUN,2016,HELICOPTER FLIGHTS,5,5,10
2,JUN,2016,HELICOPTER FLIGHTS,2,2,4
3,JUN,2016,HELICOPTER FLIGHTS,6,6,12
4,JUN,2016,HELICOPTER FLIGHTS,1,1,2
5,JUN,2016,HELICOPTER FLIGHTS,0,0,0
6,JUN,2016,HELICOPTER FLIGHTS,10,10,20
7,JUN,2016,HELICOPTER FLIGHTS,6,6,12
8,JUN,2016,HELICOPTER FLIGHTS,8,8,16
9,JUN,2016,HELICOPTER FLIGHTS,21,21,42
10,JUN,2016,HELICOPTER FLIGHTS,0,0,0
11,JUN,2016,HELICOPTER FLIGHTS,1,1,2
12,JUN,2016,HELICOPTER FLIGHTS,0,0,0
13,JUN,2016,HELICOPTER FLIGHTS,7,7,14
14,JUN,2016,HELICOPTER FLIGHTS,9,9,18
15,JUN,2016,HELICOPTER FLIGHTS,6,6,12
16,JUN,2016,HELICOPTER FLIGHTS,12,12,24
17,JUN,2016,HELICOPTER FLIGHTS,0,1,1
18,JUN,2016,HELICOPTER FLIGHTS,9,9,18
19,JUN,2016,HELICOPTER FLIGHTS,22,18,40
20,JUN,2016,HELICOPTER FLIGHTS,14,12,26
21,JUN,2016,HELICOPTER FLIGHTS,20,20,40
22,JUN,2016,HELICOPTER FLIGHTS,18,18,36
23,JUN,2016,HELICOPTER FLIGHTS,12,12,24
24,JUN,2016,HELICOPTER FLIGHTS,4,6,10
25,JUN,2016,HELICOPTER FLIGHTS,0,0,0
26,JUN,2016,HELICOPTER FLIGHTS,2,2,4
27,JUN,2016,HELICOPTER FLIGHTS,3,3,6
28,JUN,2016,HELICOPTER FLIGHTS,12,12,24
29,JUN,2016,HELICOPTER FLIGHTS,2,2,4
30,JUN,2016,HELICOPTER FLIGHTS,7,7,14
1,JUL,2016,INTERNATIONAL FLIGHTS,20,23,43
2,JUL,2016,INTERNATIONAL FLIGHTS,30,29,59
3,JUL,2016,INTERNATIONAL FLIGHTS,43,45,88
4,JUL,2016,INTERNATIONAL FLIGHTS,23,22,45
5,JUL,2016,INTERNATIONAL FLIGHTS,18,18,36
6,JUL,2016,INTERNATIONAL FLIGHTS,55,56,111
7,JUL,2016,INTERNATIONAL FLIGHTS,25,24,49
8,JUL,2016,INTERNATIONAL FLIGHTS,20,24,44
9,JUL,2016,INTERNATIONAL FLIGHTS,29,30,59
10,JUL,2016,INTERNATIONAL FLIGHTS,41,39,80
11,JUL,2016,INTERNATIONAL FLIGHTS,23,21,44
12,JUL,2016,INTERNATIONAL FLIGHTS,16,19,35
13,JUL,2016,INTERNATIONAL FLIGHTS,52,50,102
14,JUL,2016,INTERNATIONAL FLIGHTS,22,22,44
15,JUL,2016,INTERNATIONAL FLIGHTS,25,23,48
16,JUL,2016,INTERNATIONAL FLIGHTS,32,34,66
17,JUL,2016,INTERNATIONAL FLIGHTS,43,43,86
18,JUL,2016,INTERNATIONAL FLIGHTS,23,21,44
19,JUL,2016,INTERNATIONAL FLIGHTS,19,18,37
20,JUL,2016,INTERNATIONAL FLIGHTS,56,52,108
21,JUL,2016,INTERNATIONAL FLIGHTS,26,30,56
22,JUL,2016,INTERNATIONAL FLIGHTS,21,25,46
23,JUL,2016,INTERNATIONAL FLIGHTS,30,29,59
24,JUL,2016,INTERNATIONAL FLIGHTS,44,48,92
25,JUL,2016,INTERNATIONAL FLIGHTS,24,20,44
26,JUL,2016,INTERNATIONAL FLIGHTS,22,20,42
27,JUL,2016,INTERNATIONAL FLIGHTS,51,57,108
28,JUL,2016,INTERNATIONAL FLIGHTS,26,25,51
29,JUL,2016,INTERNATIONAL FLIGHTS,24,22,46
30,JUL,2016,INTERNATIONAL FLIGHTS,27,31,58
31,JUL,2016,INTERNATIONAL FLIGHTS,0,0,0
1,JUL,2016,LOCAL FLIGHTS,1,1,2
2,JUL,2016,LOCAL FLIGHTS,2,2,4
3,JUL,2016,LOCAL FLIGHTS,0,0,0
4,JUL,2016,LOCAL FLIGHTS,1,1,2
5,JUL,2016,LOCAL FLIGHTS,1,1,2
6,JUL,2016,LOCAL FLIGHTS,5,5,10
7,JUL,2016,LOCAL FLIGHTS,11,11,22
8,JUL,2016,LOCAL FLIGHTS,2,2,4
9,JUL,2016,LOCAL FLIGHTS,4,4,8
10,JUL,2016,LOCAL FLIGHTS,1,1,2
11,JUL,2016,LOCAL FLIGHTS,5,5,10
12,JUL,2016,LOCAL FLIGHTS,1,1,2
13,JUL,2016,LOCAL FLIGHTS,5,5,10
14,JUL,2016,LOCAL FLIGHTS,8,8,16
15,JUL,2016,LOCAL FLIGHTS,4,4,8
16,JUL,2016,LOCAL FLIGHTS,13,13,26
17,JUL,2016,LOCAL FLIGHTS,0,0,0
18,JUL,2016,LOCAL FLIGHTS,1,1,2
19,JUL,2016,LOCAL FLIGHTS,1,1,2
20,JUL,2016,LOCAL FLIGHTS,1,1,2
21,JUL,2016,LOCAL FLIGHTS,2,2,4
22,JUL,2016,LOCAL FLIGHTS,0,0,0
23,JUL,2016,LOCAL FLIGHTS,1,1,2
24,JUL,2016,LOCAL FLIGHTS,0,0,0
25,JUL,2016,LOCAL FLIGHTS,1,1,2
26,JUL,2016,LOCAL FLIGHTS,2,2,4
27,JUL,2016,LOCAL FLIGHTS,4,4,8
28,JUL,2016,LOCAL FLIGHTS,0,0,0
29,JUL,2016,LOCAL FLIGHTS,0,1,1
30,JUL,2016,LOCAL FLIGHTS,4,4,8
31,JUL,2016,LOCAL FLIGHTS,0,0,0
1,JUL,2016,HELICOPTER FLIGHTS,1,1,2
2,JUL,2016,HELICOPTER FLIGHTS,0,0,0
3,JUL,2016,HELICOPTER FLIGHTS,0,0,0
4,JUL,2016,HELICOPTER FLIGHTS,3,3,6
5,JUL,2016,HELICOPTER FLIGHTS,3,3,6
6,JUL,2016,HELICOPTER FLIGHTS,0,0,0
7,JUL,2016,HELICOPTER FLIGHTS,14,14,28
8,JUL,2016,HELICOPTER FLIGHTS,0,0,0
9,JUL,2016,HELICOPTER FLIGHTS,0,0,0
10,JUL,2016,HELICOPTER FLIGHTS,2,2,4
11,JUL,2016,HELICOPTER FLIGHTS,5,5,10
12,JUL,2016,HELICOPTER FLIGHTS,6,6,12
13,JUL,2016,HELICOPTER FLIGHTS,4,4,8
14,JUL,2016,HELICOPTER FLIGHTS,6,6,12
15,JUL,2016,HELICOPTER FLIGHTS,3,3,6
16,JUL,2016,HELICOPTER FLIGHTS,4,4,8
17,JUL,2016,HELICOPTER FLIGHTS,0,0,0
18,JUL,2016,HELICOPTER FLIGHTS,5,5,10
19,JUL,2016,HELICOPTER FLIGHTS,3,3,6
20,JUL,2016,HELICOPTER FLIGHTS,4,4,8
21,JUL,2016,HELICOPTER FLIGHTS,11,11,22
22,JUL,2016,HELICOPTER FLIGHTS,0,0,0
23,JUL,2016,HELICOPTER FLIGHTS,0,0,0
24,JUL,2016,HELICOPTER FLIGHTS,0,0,0
25,JUL,2016,HELICOPTER FLIGHTS,3,3,6
26,JUL,2016,HELICOPTER FLIGHTS,4,4,8
27,JUL,2016,HELICOPTER FLIGHTS,1,1,2
28,JUL,2016,HELICOPTER FLIGHTS,3,3,6
29,JUL,2016,HELICOPTER FLIGHTS,2,2,4
30,JUL,2016,HELICOPTER FLIGHTS,0,0,0
31,JUL,2016,HELICOPTER FLIGHTS,,,0
1,AUG,2016,INTERNATIONAL FLIGHTS,23,23,46
2,AUG,2016,INTERNATIONAL FLIGHTS,18,16,34
3,AUG,2016,INTERNATIONAL FLIGHTS,51,52,103
4,AUG,2016,INTERNATIONAL FLIGHTS,27,26,53
5,AUG,2016,INTERNATIONAL FLIGHTS,21,24,45
6,AUG,2016,INTERNATIONAL FLIGHTS,29,27,56
7,AUG,2016,INTERNATIONAL FLIGHTS,41,42,83
8,AUG,2016,INTERNATIONAL FLIGHTS,20,19,39
9,AUG,2016,INTERNATIONAL FLIGHTS,19,18,37
10,AUG,2016,INTERNATIONAL FLIGHTS,54,51,105
11,AUG,2016,INTERNATIONAL FLIGHTS,29,28,57
12,AUG,2016,INTERNATIONAL FLIGHTS,22,24,46
13,AUG,2016,INTERNATIONAL FLIGHTS,30,30,60
14,AUG,2016,INTERNATIONAL FLIGHTS,44,45,89
15,AUG,2016,INTERNATIONAL FLIGHTS,23,24,47
16,AUG,2016,INTERNATIONAL FLIGHTS,18,17,35
17,AUG,2016,INTERNATIONAL FLIGHTS,52,50,102
18,AUG,2016,INTERNATIONAL FLIGHTS,26,29,55
19,AUG,2016,INTERNATIONAL FLIGHTS,22,23,45
20,AUG,2016,INTERNATIONAL FLIGHTS,30,27,57
21,AUG,2016,INTERNATIONAL FLIGHTS,44,44,88
22,AUG,2016,INTERNATIONAL FLIGHTS,23,21,44
23,AUG,2016,INTERNATIONAL FLIGHTS,17,22,39
24,AUG,2016,INTERNATIONAL FLIGHTS,52,50,102
25,AUG,2016,INTERNATIONAL FLIGHTS,31,31,62
26,AUG,2016,INTERNATIONAL FLIGHTS,22,26,48
27,AUG,2016,INTERNATIONAL FLIGHTS,30,28,58
28,AUG,2016,INTERNATIONAL FLIGHTS,42,43,85
29,AUG,2016,INTERNATIONAL FLIGHTS,20,20,40
30,AUG,2016,INTERNATIONAL FLIGHTS,17,16,33
31,AUG,2016,INTERNATIONAL FLIGHTS,51,48,99
1,AUG,2016,LOCAL FLIGHTS,1,1,2
2,AUG,2016,LOCAL FLIGHTS,3,3,6
3,AUG,2016,LOCAL FLIGHTS,2,2,4
4,AUG,2016,LOCAL FLIGHTS,2,2,4
5,AUG,2016,LOCAL FLIGHTS,2,2,4
6,AUG,2016,LOCAL FLIGHTS,2,2,4
7,AUG,2016,LOCAL FLIGHTS,0,0,0
8,AUG,2016,LOCAL FLIGHTS,2,2,4
9,AUG,2016,LOCAL FLIGHTS,0,0,0
10,AUG,2016,LOCAL FLIGHTS,1,1,2
11,AUG,2016,LOCAL FLIGHTS,4,4,8
12,AUG,2016,LOCAL FLIGHTS,3,3,6
13,AUG,2016,LOCAL FLIGHTS,2,2,4
14,AUG,2016,LOCAL FLIGHTS,1,1,2
15,AUG,2016,LOCAL FLIGHTS,0,0,0
16,AUG,2016,LOCAL FLIGHTS,0,0,0
17,AUG,2016,LOCAL FLIGHTS,3,3,6
18,AUG,2016,LOCAL FLIGHTS,3,3,6
19,AUG,2016,LOCAL FLIGHTS,3,3,6
20,AUG,2016,LOCAL FLIGHTS,3,3,6
21,AUG,2016,LOCAL FLIGHTS,0,0,0
22,AUG,2016,LOCAL FLIGHTS,3,3,6
23,AUG,2016,LOCAL FLIGHTS,2,2,4
24,AUG,2016,LOCAL FLIGHTS,4,4,8
25,AUG,2016,LOCAL FLIGHTS,2,2,4
26,AUG,2016,LOCAL FLIGHTS,1,1,2
27,AUG,2016,LOCAL FLIGHTS,3,3,6
28,AUG,2016,LOCAL FLIGHTS,1,1,2
29,AUG,2016,LOCAL FLIGHTS,1,1,2
30,AUG,2016,LOCAL FLIGHTS,3,4,7
31,AUG,2016,LOCAL FLIGHTS,0,0,0
1,AUG,2016,HELICOPTER FLIGHTS,3,3,6
2,AUG,2016,HELICOPTER FLIGHTS,6,6,12
3,AUG,2016,HELICOPTER FLIGHTS,3,3,6
4,AUG,2016,HELICOPTER FLIGHTS,9,9,18
5,AUG,2016,HELICOPTER FLIGHTS,0,0,0
6,AUG,2016,HELICOPTER FLIGHTS,0,0,0
7,AUG,2016,HELICOPTER FLIGHTS,0,0,0
8,AUG,2016,HELICOPTER FLIGHTS,4,4,8
9,AUG,2016,HELICOPTER FLIGHTS,4,4,8
10,AUG,2016,HELICOPTER FLIGHTS,5,5,10
11,AUG,2016,HELICOPTER FLIGHTS,7,7,14
12,AUG,2016,HELICOPTER FLIGHTS,1,3,4
13,AUG,2016,HELICOPTER FLIGHTS,0,0,0
14,AUG,2016,HELICOPTER FLIGHTS,0,0,0
15,AUG,2016,HELICOPTER FLIGHTS,0,0,0
16,AUG,2016,HELICOPTER FLIGHTS,5,5,10
17,AUG,2016,HELICOPTER FLIGHTS,5,5,10
18,AUG,2016,HELICOPTER FLIGHTS,6,6,12
19,AUG,2016,HELICOPTER FLIGHTS,1,1,2
20,AUG,2016,HELICOPTER FLIGHTS,2,2,4
21,AUG,2016,HELICOPTER FLIGHTS,0,0,0
22,AUG,2016,HELICOPTER FLIGHTS,4,4,8
23,AUG,2016,HELICOPTER FLIGHTS,1,1,2
24,AUG,2016,HELICOPTER FLIGHTS,3,3,6
25,AUG,2016,HELICOPTER FLIGHTS,5,5,10
26,AUG,2016,HELICOPTER FLIGHTS,3,1,4
27,AUG,2016,HELICOPTER FLIGHTS,2,2,4
28,AUG,2016,HELICOPTER FLIGHTS,0,0,0
29,AUG,2016,HELICOPTER FLIGHTS,7,7,14
30,AUG,2016,HELICOPTER FLIGHTS,0,1,1
31,AUG,2016,HELICOPTER FLIGHTS,0,1,1
1,SEP,2016,INTERNATIONAL FLIGHTS,27,28,55
2,SEP,2016,INTERNATIONAL FLIGHTS,21,22,43
3,SEP,2016,INTERNATIONAL FLIGHTS,30,32,62
4,SEP,2016,INTERNATIONAL FLIGHTS,40,41,81
5,SEP,2016,INTERNATIONAL FLIGHTS,21,20,41
6,SEP,2016,INTERNATIONAL FLIGHTS,19,16,35
7,SEP,2016,INTERNATIONAL FLIGHTS,49,52,101
8,SEP,2016,INTERNATIONAL FLIGHTS,27,27,54
9,SEP,2016,INTERNATIONAL FLIGHTS,20,20,40
10,SEP,2016,INTERNATIONAL FLIGHTS,28,29,57
11,SEP,2016,INTERNATIONAL FLIGHTS,40,41,81
12,SEP,2016,INTERNATIONAL FLIGHTS,24,25,49
13,SEP,2016,INTERNATIONAL FLIGHTS,18,17,35
14,SEP,2016,INTERNATIONAL FLIGHTS,48,49,97
15,SEP,2016,INTERNATIONAL FLIGHTS,26,27,53
16,SEP,2016,INTERNATIONAL FLIGHTS,20,19,39
17,SEP,2016,INTERNATIONAL FLIGHTS,32,35,67
18,SEP,2016,INTERNATIONAL FLIGHTS,43,43,86
19,SEP,2016,INTERNATIONAL FLIGHTS,20,20,40
20,SEP,2016,INTERNATIONAL FLIGHTS,15,14,29
21,SEP,2016,INTERNATIONAL FLIGHTS,48,49,97
22,SEP,2016,INTERNATIONAL FLIGHTS,29,28,57
23,SEP,2016,INTERNATIONAL FLIGHTS,18,20,38
24,SEP,2016,INTERNATIONAL FLIGHTS,29,29,58
25,SEP,2016,INTERNATIONAL FLIGHTS,42,41,83
26,SEP,2016,INTERNATIONAL FLIGHTS,26,24,50
27,SEP,2016,INTERNATIONAL FLIGHTS,15,14,29
28,SEP,2016,INTERNATIONAL FLIGHTS,50,48,98
29,SEP,2016,INTERNATIONAL FLIGHTS,26,27,53
30,SEP,2016,INTERNATIONAL FLIGHTS,25,20,45
1,SEP,2016,LOCAL FLIGHTS,2,2,4
2,SEP,2016,LOCAL FLIGHTS,0,0,0
3,SEP,2016,LOCAL FLIGHTS,0,0,0
4,SEP,2016,LOCAL FLIGHTS,0,0,0
5,SEP,2016,LOCAL FLIGHTS,0,0,0
6,SEP,2016,LOCAL FLIGHTS,0,0,0
7,SEP,2016,LOCAL FLIGHTS,1,0,1
8,SEP,2016,LOCAL FLIGHTS,0,0,0
9,SEP,2016,LOCAL FLIGHTS,5,5,10
10,SEP,2016,LOCAL FLIGHTS,0,0,0
11,SEP,2016,LOCAL FLIGHTS,1,1,2
12,SEP,2016,LOCAL FLIGHTS,4,4,8
13,SEP,2016,LOCAL FLIGHTS,2,2,4
14,SEP,2016,LOCAL FLIGHTS,7,7,14
15,SEP,2016,LOCAL FLIGHTS,4,4,8
16,SEP,2016,LOCAL FLIGHTS,1,1,2
17,SEP,2016,LOCAL FLIGHTS,1,1,2
18,SEP,2016,LOCAL FLIGHTS,2,2,4
19,SEP,2016,LOCAL FLIGHTS,1,1,2
20,SEP,2016,LOCAL FLIGHTS,5,5,10
21,SEP,2016,LOCAL FLIGHTS,4,4,8
22,SEP,2016,LOCAL FLIGHTS,4,5,9
23,SEP,2016,LOCAL FLIGHTS,3,3,6
24,SEP,2016,LOCAL FLIGHTS,1,1,2
25,SEP,2016,LOCAL FLIGHTS,1,1,2
26,SEP,2016,LOCAL FLIGHTS,4,4,8
27,SEP,2016,LOCAL FLIGHTS,5,5,10
28,SEP,2016,LOCAL FLIGHTS,5,5,10
29,SEP,2016,LOCAL FLIGHTS,5,5,10
30,SEP,2016,LOCAL FLIGHTS,1,1,2
1,SEP,2016,HELICOPTER FLIGHTS,12,12,24
2,SEP,2016,HELICOPTER FLIGHTS,3,3,6
3,SEP,2016,HELICOPTER FLIGHTS,0,0,0
4,SEP,2016,HELICOPTER FLIGHTS,0,0,0
5,SEP,2016,HELICOPTER FLIGHTS,8,8,16
6,SEP,2016,HELICOPTER FLIGHTS,7,7,14
7,SEP,2016,HELICOPTER FLIGHTS,3,3,6
8,SEP,2016,HELICOPTER FLIGHTS,9,9,18
9,SEP,2016,HELICOPTER FLIGHTS,1,1,2
10,SEP,2016,HELICOPTER FLIGHTS,0,0,0
11,SEP,2016,HELICOPTER FLIGHTS,0,0,0
12,SEP,2016,HELICOPTER FLIGHTS,5,5,10
13,SEP,2016,HELICOPTER FLIGHTS,11,11,22
14,SEP,2016,HELICOPTER FLIGHTS,0,0,0
15,SEP,2016,HELICOPTER FLIGHTS,21,21,42
16,SEP,2016,HELICOPTER FLIGHTS,2,2,4
17,SEP,2016,HELICOPTER FLIGHTS,0,0,0
18,SEP,2016,HELICOPTER FLIGHTS,0,0,0
19,SEP,2016,HELICOPTER FLIGHTS,6,6,12
20,SEP,2016,HELICOPTER FLIGHTS,7,7,14
21,SEP,2016,HELICOPTER FLIGHTS,8,8,16
22,SEP,2016,HELICOPTER FLIGHTS,14,14,28
23,SEP,2016,HELICOPTER FLIGHTS,0,0,0
24,SEP,2016,HELICOPTER FLIGHTS,2,2,4
25,SEP,2016,HELICOPTER FLIGHTS,0,0,0
26,SEP,2016,HELICOPTER FLIGHTS,6,6,12
27,SEP,2016,HELICOPTER FLIGHTS,7,7,14
28,SEP,2016,HELICOPTER FLIGHTS,7,7,14
29,SEP,2016,HELICOPTER FLIGHTS,11,11,22
30,SEP,2016,HELICOPTER FLIGHTS,9,9,18
1,OCT,2016,INTERNATIONAL FLIGHTS,32,32,64
2,OCT,2016,INTERNATIONAL FLIGHTS,39,43,82
3,OCT,2016,INTERNATIONAL FLIGHTS,19,18,37
4,OCT,2016,INTERNATIONAL FLIGHTS,18,21,39
5,OCT,2016,INTERNATIONAL FLIGHTS,49,50,99
6,OCT,2016,INTERNATIONAL FLIGHTS,23,25,48
7,OCT,2016,INTERNATIONAL FLIGHTS,20,17,37
8,OCT,2016,INTERNATIONAL FLIGHTS,33,29,62
9,OCT,2016,INTERNATIONAL FLIGHTS,41,42,83
10,OCT,2016,INTERNATIONAL FLIGHTS,21,21,42
11,OCT,2016,INTERNATIONAL FLIGHTS,19,18,37
12,OCT,2016,INTERNATIONAL FLIGHTS,51,51,102
13,OCT,2016,INTERNATIONAL FLIGHTS,25,23,48
14,OCT,2016,INTERNATIONAL FLIGHTS,20,21,41
15,OCT,2016,INTERNATIONAL FLIGHTS,30,29,59
16,OCT,2016,INTERNATIONAL FLIGHTS,40,40,80
17,OCT,2016,INTERNATIONAL FLIGHTS,20,21,41
18,OCT,2016,INTERNATIONAL FLIGHTS,22,19,41
19,OCT,2016,INTERNATIONAL FLIGHTS,50,52,102
20,OCT,2016,INTERNATIONAL FLIGHTS,31,23,54
21,OCT,2016,INTERNATIONAL FLIGHTS,20,23,43
22,OCT,2016,INTERNATIONAL FLIGHTS,31,31,62
23,OCT,2016,INTERNATIONAL FLIGHTS,41,44,85
24,OCT,2016,INTERNATIONAL FLIGHTS,22,21,43
25,OCT,2016,INTERNATIONAL FLIGHTS,18,19,37
26,OCT,2016,INTERNATIONAL FLIGHTS,54,52,106
27,OCT,2016,INTERNATIONAL FLIGHTS,27,25,52
28,OCT,2016,INTERNATIONAL FLIGHTS,18,17,35
29,OCT,2016,INTERNATIONAL FLIGHTS,31,31,62
30,OCT,2016,INTERNATIONAL FLIGHTS,37,39,76
31,OCT,2016,INTERNATIONAL FLIGHTS,16,17,33
1,OCT,2016,LOCAL FLIGHTS,1,1,2
2,OCT,2016,LOCAL FLIGHTS,3,3,6
3,OCT,2016,LOCAL FLIGHTS,2,2,4
4,OCT,2016,LOCAL FLIGHTS,2,2,4
5,OCT,2016,LOCAL FLIGHTS,0,0,0
6,OCT,2016,LOCAL FLIGHTS,1,2,3
7,OCT,2016,LOCAL FLIGHTS,0,0,0
8,OCT,2016,LOCAL FLIGHTS,3,3,6
9,OCT,2016,LOCAL FLIGHTS,0,0,0
10,OCT,2016,LOCAL FLIGHTS,3,3,6
11,OCT,2016,LOCAL FLIGHTS,0,0,0
12,OCT,2016,LOCAL FLIGHTS,3,3,6
13,OCT,2016,LOCAL FLIGHTS,2,3,5
14,OCT,2016,LOCAL FLIGHTS,1,1,2
15,OCT,2016,LOCAL FLIGHTS,4,4,8
16,OCT,2016,LOCAL FLIGHTS,1,1,2
17,OCT,2016,LOCAL FLIGHTS,5,5,10
18,OCT,2016,LOCAL FLIGHTS,4,4,8
19,OCT,2016,LOCAL FLIGHTS,1,1,2
20,OCT,2016,LOCAL FLIGHTS,9,9,18
21,OCT,2016,LOCAL FLIGHTS,2,2,4
22,OCT,2016,LOCAL FLIGHTS,3,3,6
23,OCT,2016,LOCAL FLIGHTS,1,1,2
24,OCT,2016,LOCAL FLIGHTS,3,3,6
25,OCT,2016,LOCAL FLIGHTS,1,1,2
26,OCT,2016,LOCAL FLIGHTS,3,3,6
27,OCT,2016,LOCAL FLIGHTS,4,4,8
28,OCT,2016,LOCAL FLIGHTS,4,4,8
29,OCT,2016,LOCAL FLIGHTS,1,1,2
30,OCT,2016,LOCAL FLIGHTS,0,0,0
31,OCT,2016,LOCAL FLIGHTS,0,0,0
1,OCT,2016,HELICOPTER FLIGHTS,9,9,18
2,OCT,2016,HELICOPTER FLIGHTS,2,2,4
3,OCT,2016,HELICOPTER FLIGHTS,7,7,14
4,OCT,2016,HELICOPTER FLIGHTS,11,11,22
5,OCT,2016,HELICOPTER FLIGHTS,7,7,14
6,OCT,2016,HELICOPTER FLIGHTS,15,15,30
7,OCT,2016,HELICOPTER FLIGHTS,4,4,8
8,OCT,2016,HELICOPTER FLIGHTS,0,0,0
9,OCT,2016,HELICOPTER FLIGHTS,0,0,0
10,OCT,2016,HELICOPTER FLIGHTS,2,2,4
11,OCT,2016,HELICOPTER FLIGHTS,2,2,4
12,OCT,2016,HELICOPTER FLIGHTS,6,6,12
13,OCT,2016,HELICOPTER FLIGHTS,6,10,16
14,OCT,2016,HELICOPTER FLIGHTS,10,6,16
15,OCT,2016,HELICOPTER FLIGHTS,0,0,0
16,OCT,2016,HELICOPTER FLIGHTS,2,2,4
17,OCT,2016,HELICOPTER FLIGHTS,3,3,6
18,OCT,2016,HELICOPTER FLIGHTS,5,5,10
19,OCT,2016,HELICOPTER FLIGHTS,4,4,8
20,OCT,2016,HELICOPTER FLIGHTS,4,4,8
21,OCT,2016,HELICOPTER FLIGHTS,1,1,2
22,OCT,2016,HELICOPTER FLIGHTS,2,2,4
23,OCT,2016,HELICOPTER FLIGHTS,0,0,0
24,OCT,2016,HELICOPTER FLIGHTS,6,6,12
25,OCT,2016,HELICOPTER FLIGHTS,5,5,10
26,OCT,2016,HELICOPTER FLIGHTS,5,5,10
27,OCT,2016,HELICOPTER FLIGHTS,5,5,10
28,OCT,2016,HELICOPTER FLIGHTS,1,0,1
29,OCT,2016,HELICOPTER FLIGHTS,0,0,0
30,OCT,2016,HELICOPTER FLIGHTS,2,3,5
31,OCT,2016,HELICOPTER FLIGHTS,12,12,24
1,NOV,2016,INTERNATIONAL FLIGHTS,12,13,25
2,NOV,2016,INTERNATIONAL FLIGHTS,38,38,76
3,NOV,2016,INTERNATIONAL FLIGHTS,13,10,23
4,NOV,2016,INTERNATIONAL FLIGHTS,12,15,27
5,NOV,2016,INTERNATIONAL FLIGHTS,19,21,40
6,NOV,2016,INTERNATIONAL FLIGHTS,27,23,50
7,NOV,2016,INTERNATIONAL FLIGHTS,9,11,20
8,NOV,2016,INTERNATIONAL FLIGHTS,12,7,19
9,NOV,2016,INTERNATIONAL FLIGHTS,30,34,64
10,NOV,2016,INTERNATIONAL FLIGHTS,16,13,29
11,NOV,2016,INTERNATIONAL FLIGHTS,9,12,21
12,NOV,2016,INTERNATIONAL FLIGHTS,18,20,38
13,NOV,2016,INTERNATIONAL FLIGHTS,20,21,41
14,NOV,2016,INTERNATIONAL FLIGHTS,7,6,13
15,NOV,2016,INTERNATIONAL FLIGHTS,7,6,13
16,NOV,2016,INTERNATIONAL FLIGHTS,30,29,59
17,NOV,2016,INTERNATIONAL FLIGHTS,10,10,20
18,NOV,2016,INTERNATIONAL FLIGHTS,9,7,16
19,NOV,2016,INTERNATIONAL FLIGHTS,20,21,41
20,NOV,2016,INTERNATIONAL FLIGHTS,19,20,39
21,NOV,2016,INTERNATIONAL FLIGHTS,9,9,18
22,NOV,2016,INTERNATIONAL FLIGHTS,11,7,18
23,NOV,2016,INTERNATIONAL FLIGHTS,30,31,61
24,NOV,2016,INTERNATIONAL FLIGHTS,10,11,21
25,NOV,2016,INTERNATIONAL FLIGHTS,11,9,20
26,NOV,2016,INTERNATIONAL FLIGHTS,20,21,41
27,NOV,2016,INTERNATIONAL FLIGHTS,18,19,37
28,NOV,2016,INTERNATIONAL FLIGHTS,12,9,21
29,NOV,2016,INTERNATIONAL FLIGHTS,8,6,14
30,NOV,2016,INTERNATIONAL FLIGHTS,33,36,69
1,NOV,2016,LOCAL FLIGHTS,1,1,2
2,NOV,2016,LOCAL FLIGHTS,3,3,6
3,NOV,2016,LOCAL FLIGHTS,1,1,2
4,NOV,2016,LOCAL FLIGHTS,3,3,6
5,NOV,2016,LOCAL FLIGHTS,2,2,4
6,NOV,2016,LOCAL FLIGHTS,0,0,0
7,NOV,2016,LOCAL FLIGHTS,3,3,6
8,NOV,2016,LOCAL FLIGHTS,3,4,7
9,NOV,2016,LOCAL FLIGHTS,3,2,5
10,NOV,2016,LOCAL FLIGHTS,2,2,4
11,NOV,2016,LOCAL FLIGHTS,3,3,6
12,NOV,2016,LOCAL FLIGHTS,4,4,8
13,NOV,2016,LOCAL FLIGHTS,1,1,2
14,NOV,2016,LOCAL FLIGHTS,1,1,2
15,NOV,2016,LOCAL FLIGHTS,6,6,12
16,NOV,2016,LOCAL FLIGHTS,0,0,0
17,NOV,2016,LOCAL FLIGHTS,3,3,6
18,NOV,2016,LOCAL FLIGHTS,1,1,2
19,NOV,2016,LOCAL FLIGHTS,1,1,2
20,NOV,2016,LOCAL FLIGHTS,2,2,4
21,NOV,2016,LOCAL FLIGHTS,5,5,10
22,NOV,2016,LOCAL FLIGHTS,4,4,8
23,NOV,2016,LOCAL FLIGHTS,0,0,0
24,NOV,2016,LOCAL FLIGHTS,1,1,2
25,NOV,2016,LOCAL FLIGHTS,1,1,2
26,NOV,2016,LOCAL FLIGHTS,2,2,4
27,NOV,2016,LOCAL FLIGHTS,0,0,0
28,NOV,2016,LOCAL FLIGHTS,3,3,6
29,NOV,2016,LOCAL FLIGHTS,2,1,3
30,NOV,2016,LOCAL FLIGHTS,1,1,2
1,NOV,2016,HELICOPTER FLIGHTS,3,3,6
2,NOV,2016,HELICOPTER FLIGHTS,6,6,12
3,NOV,2016,HELICOPTER FLIGHTS,14,14,28
4,NOV,2016,HELICOPTER FLIGHTS,0,0,0
5,NOV,2016,HELICOPTER FLIGHTS,0,0,0
6,NOV,2016,HELICOPTER FLIGHTS,0,0,0
7,NOV,2016,HELICOPTER FLIGHTS,3,3,6
8,NOV,2016,HELICOPTER FLIGHTS,3,4,7
9,NOV,2016,HELICOPTER FLIGHTS,8,8,16
10,NOV,2016,HELICOPTER FLIGHTS,1,1,2
11,NOV,2016,HELICOPTER FLIGHTS,1,1,2
12,NOV,2016,HELICOPTER FLIGHTS,0,0,0
13,NOV,2016,HELICOPTER FLIGHTS,0,0,0
14,NOV,2016,HELICOPTER FLIGHTS,4,4,8
15,NOV,2016,HELICOPTER FLIGHTS,5,5,10
16,NOV,2016,HELICOPTER FLIGHTS,8,8,16
17,NOV,2016,HELICOPTER FLIGHTS,11,11,22
18,NOV,2016,HELICOPTER FLIGHTS,0,0,0
19,NOV,2016,HELICOPTER FLIGHTS,0,0,0
20,NOV,2016,HELICOPTER FLIGHTS,0,0,0
21,NOV,2016,HELICOPTER FLIGHTS,2,2,4
22,NOV,2016,HELICOPTER FLIGHTS,8,7,15
23,NOV,2016,HELICOPTER FLIGHTS,7,8,15
24,NOV,2016,HELICOPTER FLIGHTS,10,10,20
25,NOV,2016,HELICOPTER FLIGHTS,0,0,0
26,NOV,2016,HELICOPTER FLIGHTS,0,0,0
27,NOV,2016,HELICOPTER FLIGHTS,0,0,0
28,NOV,2016,HELICOPTER FLIGHTS,4,3,7
29,NOV,2016,HELICOPTER FLIGHTS,4,4,8
30,NOV,2016,HELICOPTER FLIGHTS,1,1,2
1,DEC,2016,INTERNATIONAL FLIGHTS,13,15,28
2,DEC,2016,INTERNATIONAL FLIGHTS,8,9,17
3,DEC,2016,INTERNATIONAL FLIGHTS,13,13,26
4,DEC,2016,INTERNATIONAL FLIGHTS,14,14,28
5,DEC,2016,INTERNATIONAL FLIGHTS,8,6,14
6,DEC,2016,INTERNATIONAL FLIGHTS,11,7,18
7,DEC,2016,INTERNATIONAL FLIGHTS,21,24,45
8,DEC,2016,INTERNATIONAL FLIGHTS,11,12,23
9,DEC,2016,INTERNATIONAL FLIGHTS,7,8,15
10,DEC,2016,INTERNATIONAL FLIGHTS,11,12,23
11,DEC,2016,INTERNATIONAL FLIGHTS,12,12,24
12,DEC,2016,INTERNATIONAL FLIGHTS,9,9,18
13,DEC,2016,INTERNATIONAL FLIGHTS,9,9,18
14,DEC,2016,INTERNATIONAL FLIGHTS,25,21,46
15,DEC,2016,INTERNATIONAL FLIGHTS,11,15,26
16,DEC,2016,INTERNATIONAL FLIGHTS,8,7,15
17,DEC,2016,INTERNATIONAL FLIGHTS,13,12,25
18,DEC,2016,INTERNATIONAL FLIGHTS,10,12,22
19,DEC,2016,INTERNATIONAL FLIGHTS,7,8,15
20,DEC,2016,INTERNATIONAL FLIGHTS,9,9,18
21,DEC,2016,INTERNATIONAL FLIGHTS,20,18,38
22,DEC,2016,INTERNATIONAL FLIGHTS,12,12,24
23,DEC,2016,INTERNATIONAL FLIGHTS,6,7,13
24,DEC,2016,INTERNATIONAL FLIGHTS,7,8,15
25,DEC,2016,INTERNATIONAL FLIGHTS,6,5,11
26,DEC,2016,INTERNATIONAL FLIGHTS,7,5,12
27,DEC,2016,INTERNATIONAL FLIGHTS,8,11,19
28,DEC,2016,INTERNATIONAL FLIGHTS,18,19,37
29,DEC,2016,INTERNATIONAL FLIGHTS,9,9,18
30,DEC,2016,INTERNATIONAL FLIGHTS,6,6,12
31,DEC,2016,INTERNATIONAL FLIGHTS,8,8,16
1,DEC,2016,LOCAL FLIGHTS,3,3,6
2,DEC,2016,LOCAL FLIGHTS,1,1,2
3,DEC,2016,LOCAL FLIGHTS,3,3,6
4,DEC,2016,LOCAL FLIGHTS,1,1,2
5,DEC,2016,LOCAL FLIGHTS,3,3,6
6,DEC,2016,LOCAL FLIGHTS,1,1,2
7,DEC,2016,LOCAL FLIGHTS,2,2,4
8,DEC,2016,LOCAL FLIGHTS,4,4,8
9,DEC,2016,LOCAL FLIGHTS,1,1,2
10,DEC,2016,LOCAL FLIGHTS,7,7,14
11,DEC,2016,LOCAL FLIGHTS,1,1,2
12,DEC,2016,LOCAL FLIGHTS,2,2,4
13,DEC,2016,LOCAL FLIGHTS,3,3,6
14,DEC,2016,LOCAL FLIGHTS,2,2,4
15,DEC,2016,LOCAL FLIGHTS,4,4,8
16,DEC,2016,LOCAL FLIGHTS,2,2,4
17,DEC,2016,LOCAL FLIGHTS,0,0,0
18,DEC,2016,LOCAL FLIGHTS,2,2,4
19,DEC,2016,LOCAL FLIGHTS,2,2,4
20,DEC,2016,LOCAL FLIGHTS,7,8,15
21,DEC,2016,LOCAL FLIGHTS,2,2,4
22,DEC,2016,LOCAL FLIGHTS,1,1,2
23,DEC,2016,LOCAL FLIGHTS,2,2,4
24,DEC,2016,LOCAL FLIGHTS,0,0,0
25,DEC,2016,LOCAL FLIGHTS,0,0,0
26,DEC,2016,LOCAL FLIGHTS,0,0,0
27,DEC,2016,LOCAL FLIGHTS,1,1,2
28,DEC,2016,LOCAL FLIGHTS,3,3,6
29,DEC,2016,LOCAL FLIGHTS,4,4,8
30,DEC,2016,LOCAL FLIGHTS,3,3,6
31,DEC,2016,LOCAL FLIGHTS,3,3,6
1,DEC,2016,HELICOPTER FLIGHTS,0,0,0
2,DEC,2016,HELICOPTER FLIGHTS,0,1,1
3,DEC,2016,HELICOPTER FLIGHTS,0,0,0
4,DEC,2016,HELICOPTER FLIGHTS,0,0,0
5,DEC,2016,HELICOPTER FLIGHTS,6,6,12
6,DEC,2016,HELICOPTER FLIGHTS,2,2,4
7,DEC,2016,HELICOPTER FLIGHTS,12,12,24
8,DEC,2016,HELICOPTER FLIGHTS,3,3,6
9,DEC,2016,HELICOPTER FLIGHTS,6,6,12
10,DEC,2016,HELICOPTER FLIGHTS,0,0,0
11,DEC,2016,HELICOPTER FLIGHTS,0,0,0
12,DEC,2016,HELICOPTER FLIGHTS,6,6,12
13,DEC,2016,HELICOPTER FLIGHTS,5,5,10
14,DEC,2016,HELICOPTER FLIGHTS,0,0,0
15,DEC,2016,HELICOPTER FLIGHTS,16,16,32
16,DEC,2016,HELICOPTER FLIGHTS,0,0,0
17,DEC,2016,HELICOPTER FLIGHTS,0,0,0
18,DEC,2016,HELICOPTER FLIGHTS,0,0,0
19,DEC,2016,HELICOPTER FLIGHTS,0,0,0
20,DEC,2016,HELICOPTER FLIGHTS,1,1,2
21,DEC,2016,HELICOPTER FLIGHTS,5,5,10
22,DEC,2016,HELICOPTER FLIGHTS,0,0,0
23,DEC,2016,HELICOPTER FLIGHTS,0,0,0
24,DEC,2016,HELICOPTER FLIGHTS,0,0,0
25,DEC,2016,HELICOPTER FLIGHTS,0,0,0
26,DEC,2016,HELICOPTER FLIGHTS,0,0,0
27,DEC,2016,HELICOPTER FLIGHTS,0,0,0
28,DEC,2016,HELICOPTER FLIGHTS,5,5,10
29,DEC,2016,HELICOPTER FLIGHTS,0,0,0
30,DEC,2016,HELICOPTER FLIGHTS,1,1,2
31,DEC,2016,HELICOPTER FLIGHTS,0,0,0
