DAY,MONTH,YEAR,FLIGHT_CATEGORY,INBOUND_FLIGHTS,OUTBOUND_FLIGHTS,TOTAL_FLIGHTS
1,JAN,2017,INTERNATIONAL FLIGHTS,43,45,88
2,JAN,2017,INTERNATIONAL FLIGHTS,57,54,111
3,JAN,2017,INTERNATIONAL FLIGHTS,48,55,103
4,JAN,2017,INTERNATIONAL FLIGHTS,56,54,110
5,JAN,2017,INTERNATIONAL FLIGHTS,53,57,110
6,JAN,2017,INTERNATIONAL FLIGHTS,46,43,89
7,JAN,2017,INTERNATIONAL FLIGHTS,63,57,120
8,JAN,2017,INTERNATIONAL FLIGHTS,61,70,131
9,JAN,2017,INTERNATIONAL FLIGHTS,48,47,95
10,JAN,2017,INTERNATIONAL FLIGHTS,45,48,93
11,JAN,2017,INTERNATIONAL FLIGHTS,48,45,93
12,JAN,2017,INTERNATIONAL FLIGHTS,49,51,100
13,JAN,2017,INTERNATIONAL FLIGHTS,56,49,105
14,JAN,2017,INTERNATIONAL FLIGHTS,48,53,101
15,JAN,2017,INTERNATIONAL FLIGHTS,55,56,111
16,JAN,2017,INTERNATIONAL FLIGHTS,51,49,100
17,JAN,2017,INTERNATIONAL FLIGHTS,47,48,95
18,JAN,2017,INTERNATIONAL FLIGHTS,50,46,96
19,JAN,2017,INTERNATIONAL FLIGHTS,47,52,99
20,JAN,2017,INTERNATIONAL FLIGHTS,51,50,101
21,JAN,2017,INTERNATIONAL FLIGHTS,45,44,89
22,JAN,2017,INTERNATIONAL FLIGHTS,55,56,111
23,JAN,2017,INTERNATIONAL FLIGHTS,47,47,94
24,JAN,2017,INTERNATIONAL FLIGHTS,44,42,86
25,JAN,2017,INTERNATIONAL FLIGHTS,48,42,90
26,JAN,2017,INTERNATIONAL FLIGHTS,46,51,97
27,JAN,2017,INTERNATIONAL FLIGHTS,45,42,87
28,JAN,2017,INTERNATIONAL FLIGHTS,48,50,98
29,JAN,2017,INTERNATIONAL FLIGHTS,52,51,103
30,JAN,2017,INTERNATIONAL FLIGHTS,47,45,92
31,JAN,2017,INTERNATIONAL FLIGHTS,50,44,94
1,JAN,2017,LOCAL FLIGHTS,0,0,0
2,JAN,2017,LOCAL FLIGHTS,6,6,12
3,JAN,2017,LOCAL FLIGHTS,11,11,22
4,JAN,2017,LOCAL FLIGHTS,10,10,20
5,JAN,2017,LOCAL FLIGHTS,9,9,18
6,JAN,2017,LOCAL FLIGHTS,0,0,0
7,JAN,2017,LOCAL FLIGHTS,2,2,4
8,JAN,2017,LOCAL FLIGHTS,0,0,0
9,JAN,2017,LOCAL FLIGHTS,8,8,16
10,JAN,2017,LOCAL FLIGHTS,2,2,4
11,JAN,2017,LOCAL FLIGHTS,12,12,24
12,JAN,2017,LOCAL FLIGHTS,10,10,20
13,JAN,2017,LOCAL FLIGHTS,10,11,21
14,JAN,2017,LOCAL FLIGHTS,8,8,16
15,JAN,2017,LOCAL FLIGHTS,1,1,2
16,JAN,2017,LOCAL FLIGHTS,11,11,22
17,JAN,2017,LOCAL FLIGHTS,16,16,32
18,JAN,2017,LOCAL FLIGHTS,15,15,30
19,JAN,2017,LOCAL FLIGHTS,16,16,32
20,JAN,2017,LOCAL FLIGHTS,16,16,32
21,JAN,2017,LOCAL FLIGHTS,10,10,20
22,JAN,2017,LOCAL FLIGHTS,6,6,12
23,JAN,2017,LOCAL FLIGHTS,12,12,24
24,JAN,2017,LOCAL FLIGHTS,14,14,28
25,JAN,2017,LOCAL FLIGHTS,9,9,18
26,JAN,2017,LOCAL FLIGHTS,8,9,17
27,JAN,2017,LOCAL FLIGHTS,2,2,4
28,JAN,2017,LOCAL FLIGHTS,10,10,20
29,JAN,2017,LOCAL FLIGHTS,7,7,14
30,JAN,2017,LOCAL FLIGHTS,11,11,22
31,JAN,2017,LOCAL FLIGHTS,15,15,30
1,JAN,2017,HELICOPTER FLIGHTS,0,0,0
2,JAN,2017,HELICOPTER FLIGHTS,0,0,0
3,JAN,2017,HELICOPTER FLIGHTS,1,1,2
4,JAN,2017,HELICOPTER FLIGHTS,2,2,4
5,JAN,2017,HELICOPTER FLIGHTS,1,1,2
6,JAN,2017,HELICOPTER FLIGHTS,1,1,2
7,JAN,2017,HELICOPTER FLIGHTS,0,0,0
8,JAN,2017,HELICOPTER FLIGHTS,0,0,0
9,JAN,2017,HELICOPTER FLIGHTS,3,3,6
10,JAN,2017,HELICOPTER FLIGHTS,0,0,0
11,JAN,2017,HELICOPTER FLIGHTS,2,2,4
12,JAN,2017,HELICOPTER FLIGHTS,2,2,4
13,JAN,2017,HELICOPTER FLIGHTS,1,1,2
14,JAN,2017,HELICOPTER FLIGHTS,1,1,2
15,JAN,2017,HELICOPTER FLIGHTS,0,0,0
16,JAN,2017,HELICOPTER FLIGHTS,3,3,6
17,JAN,2017,HELICOPTER FLIGHTS,2,2,4
18,JAN,2017,HELICOPTER FLIGHTS,4,4,8
19,JAN,2017,HELICOPTER FLIGHTS,1,1,2
20,JAN,2017,HELICOPTER FLIGHTS,2,2,4
21,JAN,2017,HELICOPTER FLIGHTS,1,1,2
22,JAN,2017,HELICOPTER FLIGHTS,0,0,0
23,JAN,2017,HELICOPTER FLIGHTS,2,2,4
24,JAN,2017,HELICOPTER FLIGHTS,2,2,4
25,JAN,2017,HELICOPTER FLIGHTS,2,2,4
26,JAN,2017,HELICOPTER FLIGHTS,1,1,2
27,JAN,2017,HELICOPTER FLIGHTS,1,1,2
28,JAN,2017,HELICOPTER FLIGHTS,1,1,2
29,JAN,2017,HELICOPTER FLIGHTS,0,0,0
30,JAN,2017,HELICOPTER FLIGHTS,2,2,4
31,JAN,2017,HELICOPTER FLIGHTS,1,1,2
1,FEB,2017,INTERNATIONAL FLIGHTS,49,51,100
2,FEB,2017,INTERNATIONAL FLIGHTS,48,51,99
3,FEB,2017,INTERNATIONAL FLIGHTS,46,48,94
4,FEB,2017,INTERNATIONAL FLIGHTS,47,49,96
5,FEB,2017,INTERNATIONAL FLIGHTS,52,52,104
6,FEB,2017,INTERNATIONAL FLIGHTS,50,44,94
7,FEB,2017,INTERNATIONAL FLIGHTS,44,38,82
8,FEB,2017,INTERNATIONAL FLIGHTS,53,46,99
9,FEB,2017,INTERNATIONAL FLIGHTS,52,52,104
10,FEB,2017,INTERNATIONAL FLIGHTS,56,51,107
11,FEB,2017,INTERNATIONAL FLIGHTS,51,54,105
12,FEB,2017,INTERNATIONAL FLIGHTS,58,59,117
13,FEB,2017,INTERNATIONAL FLIGHTS,49,42,91
14,FEB,2017,INTERNATIONAL FLIGHTS,46,49,95
15,FEB,2017,INTERNATIONAL FLIGHTS,50,50,100
16,FEB,2017,INTERNATIONAL FLIGHTS,59,61,120
17,FEB,2017,INTERNATIONAL FLIGHTS,55,49,104
18,FEB,2017,INTERNATIONAL FLIGHTS,50,54,104
19,FEB,2017,INTERNATIONAL FLIGHTS,56,60,116
20,FEB,2017,INTERNATIONAL FLIGHTS,50,48,98
21,FEB,2017,INTERNATIONAL FLIGHTS,45,46,91
22,FEB,2017,INTERNATIONAL FLIGHTS,58,50,108
23,FEB,2017,INTERNATIONAL FLIGHTS,56,57,113
24,FEB,2017,INTERNATIONAL FLIGHTS,51,51,102
25,FEB,2017,INTERNATIONAL FLIGHTS,35,36,71
26,FEB,2017,INTERNATIONAL FLIGHTS,55,58,113
27,FEB,2017,INTERNATIONAL FLIGHTS,45,46,91
28,FEB,2017,INTERNATIONAL FLIGHTS,53,49,102
1,FEB,2017,LOCAL FLIGHTS,10,10,20
2,FEB,2017,LOCAL FLIGHTS,16,16,32
3,FEB,2017,LOCAL FLIGHTS,10,11,21
4,FEB,2017,LOCAL FLIGHTS,20,20,40
5,FEB,2017,LOCAL FLIGHTS,4,4,8
6,FEB,2017,LOCAL FLIGHTS,15,15,30
7,FEB,2017,LOCAL FLIGHTS,13,13,26
8,FEB,2017,LOCAL FLIGHTS,9,9,18
9,FEB,2017,LOCAL FLIGHTS,4,4,8
10,FEB,2017,LOCAL FLIGHTS,8,8,16
11,FEB,2017,LOCAL FLIGHTS,11,11,22
12,FEB,2017,LOCAL FLIGHTS,0,0,0
13,FEB,2017,LOCAL FLIGHTS,15,15,30
14,FEB,2017,LOCAL FLIGHTS,12,12,24
15,FEB,2017,LOCAL FLIGHTS,11,11,22
16,FEB,2017,LOCAL FLIGHTS,2,2,4
17,FEB,2017,LOCAL FLIGHTS,16,16,32
18,FEB,2017,LOCAL FLIGHTS,14,15,29
19,FEB,2017,LOCAL FLIGHTS,0,0,0
20,FEB,2017,LOCAL FLIGHTS,10,10,20
21,FEB,2017,LOCAL FLIGHTS,11,12,23
22,FEB,2017,LOCAL FLIGHTS,10,10,20
23,FEB,2017,LOCAL FLIGHTS,19,19,38
24,FEB,2017,LOCAL FLIGHTS,10,10,20
25,FEB,2017,LOCAL FLIGHTS,10,10,20
26,FEB,2017,LOCAL FLIGHTS,1,1,2
27,FEB,2017,LOCAL FLIGHTS,5,5,10
28,FEB,2017,LOCAL FLIGHTS,7,8,15
1,FEB,2017,HELICOPTER FLIGHTS,2,2,4
2,FEB,2017,HELICOPTER FLIGHTS,2,2,4
3,FEB,2017,HELICOPTER FLIGHTS,1,1,2
4,FEB,2017,HELICOPTER FLIGHTS,2,2,4
5,FEB,2017,HELICOPTER FLIGHTS,0,0,0
6,FEB,2017,HELICOPTER FLIGHTS,1,1,2
7,FEB,2017,HELICOPTER FLIGHTS,2,2,4
8,FEB,2017,HELICOPTER FLIGHTS,4,4,8
9,FEB,2017,HELICOPTER FLIGHTS,3,3,6
10,FEB,2017,HELICOPTER FLIGHTS,3,3,6
11,FEB,2017,HELICOPTER FLIGHTS,0,0,0
12,FEB,2017,HELICOPTER FLIGHTS,0,0,0
13,FEB,2017,HELICOPTER FLIGHTS,1,0,1
14,FEB,2017,HELICOPTER FLIGHTS,1,1,2
15,FEB,2017,HELICOPTER FLIGHTS,2,2,4
16,FEB,2017,HELICOPTER FLIGHTS,2,2,4
17,FEB,2017,HELICOPTER FLIGHTS,1,1,2
18,FEB,2017,HELICOPTER FLIGHTS,1,1,2
19,FEB,2017,HELICOPTER FLIGHTS,0,0,0
20,FEB,2017,HELICOPTER FLIGHTS,3,3,6
21,FEB,2017,HELICOPTER FLIGHTS,1,1,2
22,FEB,2017,HELICOPTER FLIGHTS,1,1,2
23,FEB,2017,HELICOPTER FLIGHTS,1,1,2
24,FEB,2017,HELICOPTER FLIGHTS,2,2,4
25,FEB,2017,HELICOPTER FLIGHTS,2,2,4
26,FEB,2017,HELICOPTER FLIGHTS,0,0,0
27,FEB,2017,HELICOPTER FLIGHTS,0,0,0
28,FEB,2017,HELICOPTER FLIGHTS,1,1,2
1,MAR,2017,INTERNATIONAL FLIGHTS,55,58,113
2,MAR,2017,INTERNATIONAL FLIGHTS,50,52,102
3,MAR,2017,INTERNATIONAL FLIGHTS,65,44,109
4,MAR,2017,INTERNATIONAL FLIGHTS,55,56,111
5,MAR,2017,INTERNATIONAL FLIGHTS,65,62,127
6,MAR,2017,INTERNATIONAL FLIGHTS,54,51,105
7,MAR,2017,INTERNATIONAL FLIGHTS,45,44,89
8,MAR,2017,INTERNATIONAL FLIGHTS,56,56,112
9,MAR,2017,INTERNATIONAL FLIGHTS,55,57,112
10,MAR,2017,INTERNATIONAL FLIGHTS,47,48,95
11,MAR,2017,INTERNATIONAL FLIGHTS,56,59,115
12,MAR,2017,INTERNATIONAL FLIGHTS,66,64,130
13,MAR,2017,INTERNATIONAL FLIGHTS,56,56,112
14,MAR,2017,INTERNATIONAL FLIGHTS,43,48,91
15,MAR,2017,INTERNATIONAL FLIGHTS,57,54,111
16,MAR,2017,INTERNATIONAL FLIGHTS,57,61,118
17,MAR,2017,INTERNATIONAL FLIGHTS,61,52,113
18,MAR,2017,INTERNATIONAL FLIGHTS,66,69,135
19,MAR,2017,INTERNATIONAL FLIGHTS,63,58,121
20,MAR,2017,INTERNATIONAL FLIGHTS,55,51,106
21,MAR,2017,INTERNATIONAL FLIGHTS,46,49,95
22,MAR,2017,INTERNATIONAL FLIGHTS,62,59,121
23,MAR,2017,INTERNATIONAL FLIGHTS,59,60,119
24,MAR,2017,INTERNATIONAL FLIGHTS,52,55,107
25,MAR,2017,INTERNATIONAL FLIGHTS,61,65,126
26,MAR,2017,INTERNATIONAL FLIGHTS,76,70,146
27,MAR,2017,INTERNATIONAL FLIGHTS,61,61,122
28,MAR,2017,INTERNATIONAL FLIGHTS,62,60,122
29,MAR,2017,INTERNATIONAL FLIGHTS,63,85,148
30,MAR,2017,INTERNATIONAL FLIGHTS,67,57,124
31,MAR,2017,INTERNATIONAL FLIGHTS,69,70,139
1,MAR,2017,LOCAL FLIGHTS,7,7,14
2,MAR,2017,LOCAL FLIGHTS,15,15,30
3,MAR,2017,LOCAL FLIGHTS,19,19,38
4,MAR,2017,LOCAL FLIGHTS,19,19,38
5,MAR,2017,LOCAL FLIGHTS,2,2,4
6,MAR,2017,LOCAL FLIGHTS,10,10,20
7,MAR,2017,LOCAL FLIGHTS,23,23,46
8,MAR,2017,LOCAL FLIGHTS,19,19,38
9,MAR,2017,LOCAL FLIGHTS,9,9,18
10,MAR,2017,LOCAL FLIGHTS,5,5,10
11,MAR,2017,LOCAL FLIGHTS,0,0,0
12,MAR,2017,LOCAL FLIGHTS,0,0,0
13,MAR,2017,LOCAL FLIGHTS,13,13,26
14,MAR,2017,LOCAL FLIGHTS,22,22,44
15,MAR,2017,LOCAL FLIGHTS,21,21,42
16,MAR,2017,LOCAL FLIGHTS,16,16,32
17,MAR,2017,LOCAL FLIGHTS,15,15,30
18,MAR,2017,LOCAL FLIGHTS,24,24,48
19,MAR,2017,LOCAL FLIGHTS,11,11,22
20,MAR,2017,LOCAL FLIGHTS,14,14,28
21,MAR,2017,LOCAL FLIGHTS,16,16,32
22,MAR,2017,LOCAL FLIGHTS,17,17,34
23,MAR,2017,LOCAL FLIGHTS,16,16,32
24,MAR,2017,LOCAL FLIGHTS,21,21,42
25,MAR,2017,LOCAL FLIGHTS,7,7,14
26,MAR,2017,LOCAL FLIGHTS,4,4,8
27,MAR,2017,LOCAL FLIGHTS,19,19,38
28,MAR,2017,LOCAL FLIGHTS,17,17,34
29,MAR,2017,LOCAL FLIGHTS,25,25,50
30,MAR,2017,LOCAL FLIGHTS,13,13,26
31,MAR,2017,LOCAL FLIGHTS,13,13,26
1,MAR,2017,HELICOPTER FLIGHTS,1,1,2
2,MAR,2017,HELICOPTER FLIGHTS,2,2,4
3,MAR,2017,HELICOPTER FLIGHTS,3,3,6
4,MAR,2017,HELICOPTER FLIGHTS,1,1,2
5,MAR,2017,HELICOPTER FLIGHTS,1,1,2
6,MAR,2017,HELICOPTER FLIGHTS,4,4,8
7,MAR,2017,HELICOPTER FLIGHTS,1,1,2
8,MAR,2017,HELICOPTER FLIGHTS,2,2,4
9,MAR,2017,HELICOPTER FLIGHTS,1,1,2
10,MAR,2017,HELICOPTER FLIGHTS,0,0,0
11,MAR,2017,HELICOPTER FLIGHTS,0,0,0
12,MAR,2017,HELICOPTER FLIGHTS,0,0,0
13,MAR,2017,HELICOPTER FLIGHTS,2,2,4
14,MAR,2017,HELICOPTER FLIGHTS,1,1,2
15,MAR,2017,HELICOPTER FLIGHTS,1,1,2
16,MAR,2017,HELICOPTER FLIGHTS,1,1,2
17,MAR,2017,HELICOPTER FLIGHTS,2,2,4
18,MAR,2017,HELICOPTER FLIGHTS,0,0,0
19,MAR,2017,HELICOPTER FLIGHTS,1,1,2
20,MAR,2017,HELICOPTER FLIGHTS,1,1,2
21,MAR,2017,HELICOPTER FLIGHTS,0,0,0
22,MAR,2017,HELICOPTER FLIGHTS,1,2,3
23,MAR,2017,HELICOPTER FLIGHTS,2,2,4
24,MAR,2017,HELICOPTER FLIGHTS,1,1,2
25,MAR,2017,HELICOPTER FLIGHTS,1,1,2
26,MAR,2017,HELICOPTER FLIGHTS,1,1,2
27,MAR,2017,HELICOPTER FLIGHTS,1,1,2
28,MAR,2017,HELICOPTER FLIGHTS,3,3,6
29,MAR,2017,HELICOPTER FLIGHTS,1,1,2
30,MAR,2017,HELICOPTER FLIGHTS,3,3,6
31,MAR,2017,HELICOPTER FLIGHTS,1,1,2
1,APR,2017,INTERNATIONAL FLIGHTS,72,72,144
2,APR,2017,INTERNATIONAL FLIGHTS,76,75,151
3,APR,2017,INTERNATIONAL FLIGHTS,67,70,137
4,APR,2017,INTERNATIONAL FLIGHTS,72,0,72
5,APR,2017,INTERNATIONAL FLIGHTS,76,82,158
6,APR,2017,INTERNATIONAL FLIGHTS,66,61,127
7,APR,2017,INTERNATIONAL FLIGHTS,74,74,148
8,APR,2017,INTERNATIONAL FLIGHTS,80,79,159
9,APR,2017,INTERNATIONAL FLIGHTS,90,92,182
10,APR,2017,INTERNATIONAL FLIGHTS,84,81,165
11,APR,2017,INTERNATIONAL FLIGHTS,87,85,172
12,APR,2017,INTERNATIONAL FLIGHTS,90,95,185
13,APR,2017,INTERNATIONAL FLIGHTS,72,72,144
14,APR,2017,INTERNATIONAL FLIGHTS,79,78,157
15,APR,2017,INTERNATIONAL FLIGHTS,90,92,182
16,APR,2017,INTERNATIONAL FLIGHTS,85,85,170
17,APR,2017,INTERNATIONAL FLIGHTS,80,77,157
18,APR,2017,INTERNATIONAL FLIGHTS,88,83,171
19,APR,2017,INTERNATIONAL FLIGHTS,86,90,176
20,APR,2017,INTERNATIONAL FLIGHTS,72,70,142
21,APR,2017,INTERNATIONAL FLIGHTS,77,81,158
22,APR,2017,INTERNATIONAL FLIGHTS,77,75,152
23,APR,2017,INTERNATIONAL FLIGHTS,82,80,162
24,APR,2017,INTERNATIONAL FLIGHTS,76,78,154
25,APR,2017,INTERNATIONAL FLIGHTS,79,80,159
26,APR,2017,INTERNATIONAL FLIGHTS,90,90,180
27,APR,2017,INTERNATIONAL FLIGHTS,70,71,141
28,APR,2017,INTERNATIONAL FLIGHTS,102,94,196
29,APR,2017,INTERNATIONAL FLIGHTS,91,91,182
30,APR,2017,INTERNATIONAL FLIGHTS,93,96,189
1,APR,2017,LOCAL FLIGHTS,0,0,0
2,APR,2017,LOCAL FLIGHTS,0,0,0
3,APR,2017,LOCAL FLIGHTS,23,23,46
4,APR,2017,LOCAL FLIGHTS,18,18,36
5,APR,2017,LOCAL FLIGHTS,16,16,32
6,APR,2017,LOCAL FLIGHTS,21,21,42
7,APR,2017,LOCAL FLIGHTS,14,14,28
8,APR,2017,LOCAL FLIGHTS,6,6,12
9,APR,2017,LOCAL FLIGHTS,0,0,0
10,APR,2017,LOCAL FLIGHTS,18,18,36
11,APR,2017,LOCAL FLIGHTS,9,9,18
12,APR,2017,LOCAL FLIGHTS,5,5,10
13,APR,2017,LOCAL FLIGHTS,5,5,10
14,APR,2017,LOCAL FLIGHTS,7,7,14
15,APR,2017,LOCAL FLIGHTS,1,1,2
16,APR,2017,LOCAL FLIGHTS,0,0,0
17,APR,2017,LOCAL FLIGHTS,3,3,6
18,APR,2017,LOCAL FLIGHTS,19,19,38
19,APR,2017,LOCAL FLIGHTS,16,16,32
20,APR,2017,LOCAL FLIGHTS,22,22,44
21,APR,2017,LOCAL FLIGHTS,14,15,29
22,APR,2017,LOCAL FLIGHTS,28,28,56
23,APR,2017,LOCAL FLIGHTS,0,0,0
24,APR,2017,LOCAL FLIGHTS,10,10,20
25,APR,2017,LOCAL FLIGHTS,11,11,22
26,APR,2017,LOCAL FLIGHTS,16,15,31
27,APR,2017,LOCAL FLIGHTS,12,12,24
28,APR,2017,LOCAL FLIGHTS,14,15,29
29,APR,2017,LOCAL FLIGHTS,2,2,4
30,APR,2017,LOCAL FLIGHTS,5,5,10
1,APR,2017,HELICOPTER FLIGHTS,0,0,0
2,APR,2017,HELICOPTER FLIGHTS,0,0,0
3,APR,2017,HELICOPTER FLIGHTS,2,2,4
4,APR,2017,HELICOPTER FLIGHTS,2,2,4
5,APR,2017,HELICOPTER FLIGHTS,3,3,6
6,APR,2017,HELICOPTER FLIGHTS,2,2,4
7,APR,2017,HELICOPTER FLIGHTS,1,1,2
8,APR,2017,HELICOPTER FLIGHTS,0,0,0
9,APR,2017,HELICOPTER FLIGHTS,0,0,0
10,APR,2017,HELICOPTER FLIGHTS,2,2,4
11,APR,2017,HELICOPTER FLIGHTS,1,1,2
12,APR,2017,HELICOPTER FLIGHTS,1,2,3
13,APR,2017,HELICOPTER FLIGHTS,3,3,6
14,APR,2017,HELICOPTER FLIGHTS,0,0,0
15,APR,2017,HELICOPTER FLIGHTS,1,1,2
16,APR,2017,HELICOPTER FLIGHTS,0,0,0
17,APR,2017,HELICOPTER FLIGHTS,0,0,0
18,APR,2017,HELICOPTER FLIGHTS,0,0,0
19,APR,2017,HELICOPTER FLIGHTS,1,1,2
20,APR,2017,HELICOPTER FLIGHTS,1,1,2
21,APR,2017,HELICOPTER FLIGHTS,3,3,6
22,APR,2017,HELICOPTER FLIGHTS,0,0,0
23,APR,2017,HELICOPTER FLIGHTS,1,1,2
24,APR,2017,HELICOPTER FLIGHTS,2,2,4
25,APR,2017,HELICOPTER FLIGHTS,2,2,4
26,APR,2017,HELICOPTER FLIGHTS,3,3,6
27,APR,2017,HELICOPTER FLIGHTS,2,2,4
28,APR,2017,HELICOPTER FLIGHTS,0,0,0
29,APR,2017,HELICOPTER FLIGHTS,1,1,2
30,APR,2017,HELICOPTER FLIGHTS,0,0,0
1,MAY,2017,INTERNATIONAL FLIGHTS,86,93,179
2,MAY,2017,INTERNATIONAL FLIGHTS,83,81,164
3,MAY,2017,INTERNATIONAL FLIGHTS,96,99,195
4,MAY,2017,INTERNATIONAL FLIGHTS,88,81,169
5,MAY,2017,INTERNATIONAL FLIGHTS,94,91,185
6,MAY,2017,INTERNATIONAL FLIGHTS,95,93,188
7,MAY,2017,INTERNATIONAL FLIGHTS,103,111,214
8,MAY,2017,INTERNATIONAL FLIGHTS,95,96,191
9,MAY,2017,INTERNATIONAL FLIGHTS,79,79,158
10,MAY,2017,INTERNATIONAL FLIGHTS,99,96,195
11,MAY,2017,INTERNATIONAL FLIGHTS,87,90,177
12,MAY,2017,INTERNATIONAL FLIGHTS,95,93,188
13,MAY,2017,INTERNATIONAL FLIGHTS,90,94,184
14,MAY,2017,INTERNATIONAL FLIGHTS,114,111,225
15,MAY,2017,INTERNATIONAL FLIGHTS,78,72,150
16,MAY,2017,INTERNATIONAL FLIGHTS,71,76,147
17,MAY,2017,INTERNATIONAL FLIGHTS,96,100,196
18,MAY,2017,INTERNATIONAL FLIGHTS,93,89,182
19,MAY,2017,INTERNATIONAL FLIGHTS,94,98,192
20,MAY,2017,INTERNATIONAL FLIGHTS,93,100,193
21,MAY,2017,INTERNATIONAL FLIGHTS,114,108,222
22,MAY,2017,INTERNATIONAL FLIGHTS,92,94,186
23,MAY,2017,INTERNATIONAL FLIGHTS,77,78,155
24,MAY,2017,INTERNATIONAL FLIGHTS,108,108,216
25,MAY,2017,INTERNATIONAL FLIGHTS,101,102,203
26,MAY,2017,INTERNATIONAL FLIGHTS,105,100,205
27,MAY,2017,INTERNATIONAL FLIGHTS,91,100,191
28,MAY,2017,INTERNATIONAL FLIGHTS,110,117,227
29,MAY,2017,INTERNATIONAL FLIGHTS,107,109,216
30,MAY,2017,INTERNATIONAL FLIGHTS,90,83,173
31,MAY,2017,INTERNATIONAL FLIGHTS,101,111,212
1,MAY,2017,LOCAL FLIGHTS,9,9,18
2,MAY,2017,LOCAL FLIGHTS,5,5,10
3,MAY,2017,LOCAL FLIGHTS,9,10,19
4,MAY,2017,LOCAL FLIGHTS,11,11,22
5,MAY,2017,LOCAL FLIGHTS,17,17,34
6,MAY,2017,LOCAL FLIGHTS,11,11,22
7,MAY,2017,LOCAL FLIGHTS,5,5,10
8,MAY,2017,LOCAL FLIGHTS,11,11,22
9,MAY,2017,LOCAL FLIGHTS,15,15,30
10,MAY,2017,LOCAL FLIGHTS,5,5,10
11,MAY,2017,LOCAL FLIGHTS,17,15,32
12,MAY,2017,LOCAL FLIGHTS,9,9,18
13,MAY,2017,LOCAL FLIGHTS,9,9,18
14,MAY,2017,LOCAL FLIGHTS,2,2,4
15,MAY,2017,LOCAL FLIGHTS,14,15,29
16,MAY,2017,LOCAL FLIGHTS,20,20,40
17,MAY,2017,LOCAL FLIGHTS,13,12,25
18,MAY,2017,LOCAL FLIGHTS,10,10,20
19,MAY,2017,LOCAL FLIGHTS,8,8,16
20,MAY,2017,LOCAL FLIGHTS,3,2,5
21,MAY,2017,LOCAL FLIGHTS,2,2,4
22,MAY,2017,LOCAL FLIGHTS,12,12,24
23,MAY,2017,LOCAL FLIGHTS,8,8,16
24,MAY,2017,LOCAL FLIGHTS,14,14,28
25,MAY,2017,LOCAL FLIGHTS,17,17,34
26,MAY,2017,LOCAL FLIGHTS,15,15,30
27,MAY,2017,LOCAL FLIGHTS,23,24,47
28,MAY,2017,LOCAL FLIGHTS,3,3,6
29,MAY,2017,LOCAL FLIGHTS,17,17,34
30,MAY,2017,LOCAL FLIGHTS,23,23,46
31,MAY,2017,LOCAL FLIGHTS,16,16,32
1,MAY,2017,HELICOPTER FLIGHTS,0,0,0
2,MAY,2017,HELICOPTER FLIGHTS,1,1,2
3,MAY,2017,HELICOPTER FLIGHTS,3,3,6
4,MAY,2017,HELICOPTER FLIGHTS,2,2,4
5,MAY,2017,HELICOPTER FLIGHTS,1,1,2
6,MAY,2017,HELICOPTER FLIGHTS,1,1,2
7,MAY,2017,HELICOPTER FLIGHTS,1,1,2
8,MAY,2017,HELICOPTER FLIGHTS,2,2,4
9,MAY,2017,HELICOPTER FLIGHTS,4,4,8
10,MAY,2017,HELICOPTER FLIGHTS,2,2,4
11,MAY,2017,HELICOPTER FLIGHTS,1,1,2
12,MAY,2017,HELICOPTER FLIGHTS,0,0,0
13,MAY,2017,HELICOPTER FLIGHTS,1,1,2
14,MAY,2017,HELICOPTER FLIGHTS,0,0,0
15,MAY,2017,HELICOPTER FLIGHTS,2,2,4
16,MAY,2017,HELICOPTER FLIGHTS,1,1,2
17,MAY,2017,HELICOPTER FLIGHTS,1,1,2
18,MAY,2017,HELICOPTER FLIGHTS,1,1,2
19,MAY,2017,HELICOPTER FLIGHTS,1,1,2
20,MAY,2017,HELICOPTER FLIGHTS,0,0,0
21,MAY,2017,HELICOPTER FLIGHTS,1,1,2
22,MAY,2017,HELICOPTER FLIGHTS,2,2,4
23,MAY,2017,HELICOPTER FLIGHTS,1,2,3
24,MAY,2017,HELICOPTER FLIGHTS,3,3,6
25,MAY,2017,HELICOPTER FLIGHTS,1,1,2
26,MAY,2017,HELICOPTER FLIGHTS,2,2,4
27,MAY,2017,HELICOPTER FLIGHTS,1,1,2
28,MAY,2017,HELICOPTER FLIGHTS,1,1,2
29,MAY,2017,HELICOPTER FLIGHTS,2,2,4
30,MAY,2017,HELICOPTER FLIGHTS,1,1,2
31,MAY,2017,HELICOPTER FLIGHTS,2,0,2
1,JUN,2017,INTERNATIONAL FLIGHTS,95,98,193
2,JUN,2017,INTERNATIONAL FLIGHTS,109,107,216
3,JUN,2017,INTERNATIONAL FLIGHTS,125,123,248
4,JUN,2017,INTERNATIONAL FLIGHTS,116,120,236
5,JUN,2017,INTERNATIONAL FLIGHTS,110,109,219
6,JUN,2017,INTERNATIONAL FLIGHTS,75,72,147
7,JUN,2017,INTERNATIONAL FLIGHTS,108,110,218
8,JUN,2017,INTERNATIONAL FLIGHTS,93,93,186
9,JUN,2017,INTERNATIONAL FLIGHTS,103,96,199
10,JUN,2017,INTERNATIONAL FLIGHTS,107,108,215
11,JUN,2017,INTERNATIONAL FLIGHTS,123,122,245
12,JUN,2017,INTERNATIONAL FLIGHTS,107,108,215
13,JUN,2017,INTERNATIONAL FLIGHTS,80,77,157
14,JUN,2017,INTERNATIONAL FLIGHTS,112,109,221
15,JUN,2017,INTERNATIONAL FLIGHTS,106,104,210
16,JUN,2017,INTERNATIONAL FLIGHTS,107,101,208
17,JUN,2017,INTERNATIONAL FLIGHTS,101,109,210
18,JUN,2017,INTERNATIONAL FLIGHTS,125,124,249
19,JUN,2017,INTERNATIONAL FLIGHTS,106,106,212
20,JUN,2017,INTERNATIONAL FLIGHTS,77,72,149
21,JUN,2017,INTERNATIONAL FLIGHTS,119,115,234
22,JUN,2017,INTERNATIONAL FLIGHTS,112,106,218
23,JUN,2017,INTERNATIONAL FLIGHTS,112,113,225
24,JUN,2017,INTERNATIONAL FLIGHTS,112,115,227
25,JUN,2017,INTERNATIONAL FLIGHTS,138,132,270
26,JUN,2017,INTERNATIONAL FLIGHTS,109,122,231
27,JUN,2017,INTERNATIONAL FLIGHTS,83,84,167
28,JUN,2017,INTERNATIONAL FLIGHTS,121,119,240
29,JUN,2017,INTERNATIONAL FLIGHTS,107,106,213
30,JUN,2017,INTERNATIONAL FLIGHTS,123,122,245
1,JUN,2017,LOCAL FLIGHTS,16,16,32
2,JUN,2017,LOCAL FLIGHTS,17,17,34
3,JUN,2017,LOCAL FLIGHTS,10,10,20
4,JUN,2017,LOCAL FLIGHTS,1,1,2
5,JUN,2017,LOCAL FLIGHTS,2,2,4
6,JUN,2017,LOCAL FLIGHTS,14,14,28
7,JUN,2017,LOCAL FLIGHTS,15,15,30
8,JUN,2017,LOCAL FLIGHTS,11,11,22
9,JUN,2017,LOCAL FLIGHTS,10,10,20
10,JUN,2017,LOCAL FLIGHTS,15,15,30
11,JUN,2017,LOCAL FLIGHTS,0,0,0
12,JUN,2017,LOCAL FLIGHTS,7,7,14
13,JUN,2017,LOCAL FLIGHTS,15,15,30
14,JUN,2017,LOCAL FLIGHTS,9,9,18
15,JUN,2017,LOCAL FLIGHTS,24,24,48
16,JUN,2017,LOCAL FLIGHTS,23,23,46
17,JUN,2017,LOCAL FLIGHTS,16,16,32
18,JUN,2017,LOCAL FLIGHTS,6,6,12
19,JUN,2017,LOCAL FLIGHTS,16,16,32
20,JUN,2017,LOCAL FLIGHTS,21,21,42
21,JUN,2017,LOCAL FLIGHTS,12,12,24
22,JUN,2017,LOCAL FLIGHTS,14,14,28
23,JUN,2017,LOCAL FLIGHTS,18,18,36
24,JUN,2017,LOCAL FLIGHTS,17,17,34
25,JUN,2017,LOCAL FLIGHTS,4,4,8
26,JUN,2017,LOCAL FLIGHTS,15,15,30
27,JUN,2017,LOCAL FLIGHTS,21,21,42
28,JUN,2017,LOCAL FLIGHTS,23,23,46
29,JUN,2017,LOCAL FLIGHTS,22,22,44
30,JUN,2017,LOCAL FLIGHTS,8,8,16
1,JUN,2017,HELICOPTER FLIGHTS,3,3,6
2,JUN,2017,HELICOPTER FLIGHTS,0,0,0
3,JUN,2017,HELICOPTER FLIGHTS,0,0,0
4,JUN,2017,HELICOPTER FLIGHTS,1,1,2
5,JUN,2017,HELICOPTER FLIGHTS,0,0,0
6,JUN,2017,HELICOPTER FLIGHTS,1,1,2
7,JUN,2017,HELICOPTER FLIGHTS,2,2,4
8,JUN,2017,HELICOPTER FLIGHTS,1,1,2
9,JUN,2017,HELICOPTER FLIGHTS,1,1,2
10,JUN,2017,HELICOPTER FLIGHTS,0,0,0
11,JUN,2017,HELICOPTER FLIGHTS,0,0,0
12,JUN,2017,HELICOPTER FLIGHTS,1,1,2
13,JUN,2017,HELICOPTER FLIGHTS,1,1,2
14,JUN,2017,HELICOPTER FLIGHTS,1,1,2
15,JUN,2017,HELICOPTER FLIGHTS,0,0,0
16,JUN,2017,HELICOPTER FLIGHTS,0,0,0
17,JUN,2017,HELICOPTER FLIGHTS,0,0,0
18,JUN,2017,HELICOPTER FLIGHTS,0,0,0
19,JUN,2017,HELICOPTER FLIGHTS,2,2,4
20,JUN,2017,HELICOPTER FLIGHTS,2,2,4
21,JUN,2017,HELICOPTER FLIGHTS,0,0,0
22,JUN,2017,HELICOPTER FLIGHTS,3,3,6
23,JUN,2017,HELICOPTER FLIGHTS,0,0,0
24,JUN,2017,HELICOPTER FLIGHTS,1,1,2
25,JUN,2017,HELICOPTER FLIGHTS,10,3,13
26,JUN,2017,HELICOPTER FLIGHTS,2,2,4
27,JUN,2017,HELICOPTER FLIGHTS,3,3,6
28,JUN,2017,HELICOPTER FLIGHTS,1,1,2
29,JUN,2017,HELICOPTER FLIGHTS,0,0,0
30,JUN,2017,HELICOPTER FLIGHTS,0,0,0
1,JUL,2017,INTERNATIONAL FLIGHTS,118,121,239
2,JUL,2017,INTERNATIONAL FLIGHTS,129,128,257
3,JUL,2017,INTERNATIONAL FLIGHTS,122,120,242
4,JUL,2017,INTERNATIONAL FLIGHTS,88,90,178
5,JUL,2017,INTERNATIONAL FLIGHTS,129,125,254
6,JUL,2017,INTERNATIONAL FLIGHTS,108,106,214
7,JUL,2017,INTERNATIONAL FLIGHTS,120,119,239
8,JUL,2017,INTERNATIONAL FLIGHTS,118,121,239
9,JUL,2017,INTERNATIONAL FLIGHTS,139,139,278
10,JUL,2017,INTERNATIONAL FLIGHTS,121,117,238
11,JUL,2017,INTERNATIONAL FLIGHTS,95,91,186
12,JUL,2017,INTERNATIONAL FLIGHTS,125,127,252
13,JUL,2017,INTERNATIONAL FLIGHTS,106,106,212
14,JUL,2017,INTERNATIONAL FLIGHTS,120,121,241
15,JUL,2017,INTERNATIONAL FLIGHTS,115,121,236
16,JUL,2017,INTERNATIONAL FLIGHTS,136,135,271
17,JUL,2017,INTERNATIONAL FLIGHTS,133,125,258
18,JUL,2017,INTERNATIONAL FLIGHTS,104,104,208
19,JUL,2017,INTERNATIONAL FLIGHTS,128,131,259
20,JUL,2017,INTERNATIONAL FLIGHTS,113,108,221
21,JUL,2017,INTERNATIONAL FLIGHTS,127,122,249
22,JUL,2017,INTERNATIONAL FLIGHTS,110,119,229
23,JUL,2017,INTERNATIONAL FLIGHTS,139,138,277
24,JUL,2017,INTERNATIONAL FLIGHTS,128,127,255
25,JUL,2017,INTERNATIONAL FLIGHTS,102,102,204
26,JUL,2017,INTERNATIONAL FLIGHTS,126,123,249
27,JUL,2017,INTERNATIONAL FLIGHTS,111,113,224
28,JUL,2017,INTERNATIONAL FLIGHTS,122,122,244
29,JUL,2017,INTERNATIONAL FLIGHTS,118,124,242
30,JUL,2017,INTERNATIONAL FLIGHTS,136,132,268
31,JUL,2017,INTERNATIONAL FLIGHTS,127,126,253
1,JUL,2017,LOCAL FLIGHTS,22,22,44
2,JUL,2017,LOCAL FLIGHTS,5,5,10
3,JUL,2017,LOCAL FLIGHTS,17,17,34
4,JUL,2017,LOCAL FLIGHTS,20,20,40
5,JUL,2017,LOCAL FLIGHTS,18,30,48
6,JUL,2017,LOCAL FLIGHTS,0,12,12
7,JUL,2017,LOCAL FLIGHTS,21,36,57
8,JUL,2017,LOCAL FLIGHTS,15,0,15
9,JUL,2017,LOCAL FLIGHTS,3,3,6
10,JUL,2017,LOCAL FLIGHTS,14,14,28
11,JUL,2017,LOCAL FLIGHTS,22,22,44
12,JUL,2017,LOCAL FLIGHTS,11,11,22
13,JUL,2017,LOCAL FLIGHTS,20,20,40
14,JUL,2017,LOCAL FLIGHTS,11,11,22
15,JUL,2017,LOCAL FLIGHTS,11,11,22
16,JUL,2017,LOCAL FLIGHTS,5,5,10
17,JUL,2017,LOCAL FLIGHTS,13,13,26
18,JUL,2017,LOCAL FLIGHTS,16,16,32
19,JUL,2017,LOCAL FLIGHTS,7,7,14
20,JUL,2017,LOCAL FLIGHTS,18,18,36
21,JUL,2017,LOCAL FLIGHTS,15,15,30
22,JUL,2017,LOCAL FLIGHTS,24,24,48
23,JUL,2017,LOCAL FLIGHTS,3,4,7
24,JUL,2017,LOCAL FLIGHTS,17,17,34
25,JUL,2017,LOCAL FLIGHTS,14,14,28
26,JUL,2017,LOCAL FLIGHTS,13,13,26
27,JUL,2017,LOCAL FLIGHTS,22,22,44
28,JUL,2017,LOCAL FLIGHTS,20,20,40
29,JUL,2017,LOCAL FLIGHTS,14,14,28
30,JUL,2017,LOCAL FLIGHTS,5,5,10
31,JUL,2017,LOCAL FLIGHTS,17,17,34
1,JUL,2017,HELICOPTER FLIGHTS,0,0,0
2,JUL,2017,HELICOPTER FLIGHTS,0,0,0
3,JUL,2017,HELICOPTER FLIGHTS,1,1,2
4,JUL,2017,HELICOPTER FLIGHTS,2,2,4
5,JUL,2017,HELICOPTER FLIGHTS,0,0,0
6,JUL,2017,HELICOPTER FLIGHTS,2,2,4
7,JUL,2017,HELICOPTER FLIGHTS,0,0,0
8,JUL,2017,HELICOPTER FLIGHTS,0,0,0
9,JUL,2017,HELICOPTER FLIGHTS,0,0,0
10,JUL,2017,HELICOPTER FLIGHTS,2,2,4
11,JUL,2017,HELICOPTER FLIGHTS,3,3,6
12,JUL,2017,HELICOPTER FLIGHTS,2,2,4
13,JUL,2017,HELICOPTER FLIGHTS,5,5,10
14,JUL,2017,HELICOPTER FLIGHTS,2,2,4
15,JUL,2017,HELICOPTER FLIGHTS,4,4,8
16,JUL,2017,HELICOPTER FLIGHTS,2,4,6
17,JUL,2017,HELICOPTER FLIGHTS,6,6,12
18,JUL,2017,HELICOPTER FLIGHTS,2,2,4
19,JUL,2017,HELICOPTER FLIGHTS,3,3,6
20,JUL,2017,HELICOPTER FLIGHTS,7,7,14
21,JUL,2017,HELICOPTER FLIGHTS,4,4,8
22,JUL,2017,HELICOPTER FLIGHTS,3,3,6
23,JUL,2017,HELICOPTER FLIGHTS,0,0,0
24,JUL,2017,HELICOPTER FLIGHTS,1,1,2
25,JUL,2017,HELICOPTER FLIGHTS,2,2,4
26,JUL,2017,HELICOPTER FLIGHTS,2,2,4
27,JUL,2017,HELICOPTER FLIGHTS,4,4,8
28,JUL,2017,HELICOPTER FLIGHTS,1,1,2
29,JUL,2017,HELICOPTER FLIGHTS,3,3,6
30,JUL,2017,HELICOPTER FLIGHTS,1,1,2
31,JUL,2017,HELICOPTER FLIGHTS,1,1,2
1,AUG,2017,INTERNATIONAL FLIGHTS,100,97,197
2,AUG,2017,INTERNATIONAL FLIGHTS,129,127,256
3,AUG,2017,INTERNATIONAL FLIGHTS,110,109,219
4,AUG,2017,INTERNATIONAL FLIGHTS,123,127,250
5,AUG,2017,INTERNATIONAL FLIGHTS,114,119,233
6,AUG,2017,INTERNATIONAL FLIGHTS,139,133,272
7,AUG,2017,INTERNATIONAL FLIGHTS,101,120,221
8,AUG,2017,INTERNATIONAL FLIGHTS,95,91,186
9,AUG,2017,INTERNATIONAL FLIGHTS,127,128,255
10,AUG,2017,INTERNATIONAL FLIGHTS,109,107,216
11,AUG,2017,INTERNATIONAL FLIGHTS,122,126,248
12,AUG,2017,INTERNATIONAL FLIGHTS,125,128,253
13,AUG,2017,INTERNATIONAL FLIGHTS,136,132,268
14,AUG,2017,INTERNATIONAL FLIGHTS,120,120,240
15,AUG,2017,INTERNATIONAL FLIGHTS,97,96,193
16,AUG,2017,INTERNATIONAL FLIGHTS,128,129,257
17,AUG,2017,INTERNATIONAL FLIGHTS,109,108,217
18,AUG,2017,INTERNATIONAL FLIGHTS,122,124,246
19,AUG,2017,INTERNATIONAL FLIGHTS,116,120,236
20,AUG,2017,INTERNATIONAL FLIGHTS,139,132,271
21,AUG,2017,INTERNATIONAL FLIGHTS,121,122,243
22,AUG,2017,INTERNATIONAL FLIGHTS,96,99,195
23,AUG,2017,INTERNATIONAL FLIGHTS,134,129,263
24,AUG,2017,INTERNATIONAL FLIGHTS,112,112,224
25,AUG,2017,INTERNATIONAL FLIGHTS,132,128,260
26,AUG,2017,INTERNATIONAL FLIGHTS,118,125,243
27,AUG,2017,INTERNATIONAL FLIGHTS,135,134,269
28,AUG,2017,INTERNATIONAL FLIGHTS,127,131,258
29,AUG,2017,INTERNATIONAL FLIGHTS,101,100,201
30,AUG,2017,INTERNATIONAL FLIGHTS,133,133,266
31,AUG,2017,INTERNATIONAL FLIGHTS,112,108,220
1,AUG,2017,LOCAL FLIGHTS,22,22,44
2,AUG,2017,LOCAL FLIGHTS,18,18,36
3,AUG,2017,LOCAL FLIGHTS,22,22,44
4,AUG,2017,LOCAL FLIGHTS,17,16,33
5,AUG,2017,LOCAL FLIGHTS,17,17,34
6,AUG,2017,LOCAL FLIGHTS,6,6,12
7,AUG,2017,LOCAL FLIGHTS,17,17,34
8,AUG,2017,LOCAL FLIGHTS,18,18,36
9,AUG,2017,LOCAL FLIGHTS,11,11,22
10,AUG,2017,LOCAL FLIGHTS,19,19,38
11,AUG,2017,LOCAL FLIGHTS,13,13,26
12,AUG,2017,LOCAL FLIGHTS,11,11,22
13,AUG,2017,LOCAL FLIGHTS,2,2,4
14,AUG,2017,LOCAL FLIGHTS,4,4,8
15,AUG,2017,LOCAL FLIGHTS,3,3,6
16,AUG,2017,LOCAL FLIGHTS,6,6,12
17,AUG,2017,LOCAL FLIGHTS,14,14,28
18,AUG,2017,LOCAL FLIGHTS,19,19,38
19,AUG,2017,LOCAL FLIGHTS,10,10,20
20,AUG,2017,LOCAL FLIGHTS,0,0,0
21,AUG,2017,LOCAL FLIGHTS,20,20,40
22,AUG,2017,LOCAL FLIGHTS,1,14,15
23,AUG,2017,LOCAL FLIGHTS,13,13,26
24,AUG,2017,LOCAL FLIGHTS,17,17,34
25,AUG,2017,LOCAL FLIGHTS,7,7,14
26,AUG,2017,LOCAL FLIGHTS,15,15,30
27,AUG,2017,LOCAL FLIGHTS,4,4,8
28,AUG,2017,LOCAL FLIGHTS,10,10,20
29,AUG,2017,LOCAL FLIGHTS,16,16,32
30,AUG,2017,LOCAL FLIGHTS,7,7,14
31,AUG,2017,LOCAL FLIGHTS,12,12,24
1,AUG,2017,HELICOPTER FLIGHTS,2,2,4
2,AUG,2017,HELICOPTER FLIGHTS,4,4,8
3,AUG,2017,HELICOPTER FLIGHTS,1,1,2
4,AUG,2017,HELICOPTER FLIGHTS,0,0,0
5,AUG,2017,HELICOPTER FLIGHTS,1,1,2
6,AUG,2017,HELICOPTER FLIGHTS,1,1,2
7,AUG,2017,HELICOPTER FLIGHTS,2,2,4
8,AUG,2017,HELICOPTER FLIGHTS,2,2,4
9,AUG,2017,HELICOPTER FLIGHTS,4,4,8
10,AUG,2017,HELICOPTER FLIGHTS,4,4,8
11,AUG,2017,HELICOPTER FLIGHTS,5,5,10
12,AUG,2017,HELICOPTER FLIGHTS,4,4,8
13,AUG,2017,HELICOPTER FLIGHTS,3,3,6
14,AUG,2017,HELICOPTER FLIGHTS,1,1,2
15,AUG,2017,HELICOPTER FLIGHTS,3,3,6
16,AUG,2017,HELICOPTER FLIGHTS,3,3,6
17,AUG,2017,HELICOPTER FLIGHTS,6,6,12
18,AUG,2017,HELICOPTER FLIGHTS,4,4,8
19,AUG,2017,HELICOPTER FLIGHTS,0,0,0
20,AUG,2017,HELICOPTER FLIGHTS,0,0,0
21,AUG,2017,HELICOPTER FLIGHTS,3,3,6
22,AUG,2017,HELICOPTER FLIGHTS,2,2,4
23,AUG,2017,HELICOPTER FLIGHTS,2,2,4
24,AUG,2017,HELICOPTER FLIGHTS,2,2,4
25,AUG,2017,HELICOPTER FLIGHTS,2,2,4
26,AUG,2017,HELICOPTER FLIGHTS,0,0,0
27,AUG,2017,HELICOPTER FLIGHTS,0,0,0
28,AUG,2017,HELICOPTER FLIGHTS,4,3,7
29,AUG,2017,HELICOPTER FLIGHTS,2,2,4
30,AUG,2017,HELICOPTER FLIGHTS,2,2,4
31,AUG,2017,HELICOPTER FLIGHTS,4,3,7
1,SEP,2017,INTERNATIONAL FLIGHTS,122,124,246
2,SEP,2017,INTERNATIONAL FLIGHTS,114,119,233
3,SEP,2017,INTERNATIONAL FLIGHTS,133,130,263
4,SEP,2017,INTERNATIONAL FLIGHTS,126,121,247
5,SEP,2017,INTERNATIONAL FLIGHTS,90,94,184
6,SEP,2017,INTERNATIONAL FLIGHTS,124,117,241
7,SEP,2017,INTERNATIONAL FLIGHTS,111,116,227
8,SEP,2017,INTERNATIONAL FLIGHTS,112,114,226
9,SEP,2017,INTERNATIONAL FLIGHTS,117,113,230
10,SEP,2017,INTERNATIONAL FLIGHTS,128,127,255
11,SEP,2017,INTERNATIONAL FLIGHTS,118,115,233
12,SEP,2017,INTERNATIONAL FLIGHTS,88,92,180
13,SEP,2017,INTERNATIONAL FLIGHTS,120,118,238
14,SEP,2017,INTERNATIONAL FLIGHTS,115,115,230
15,SEP,2017,INTERNATIONAL FLIGHTS,117,117,234
16,SEP,2017,INTERNATIONAL FLIGHTS,107,111,218
17,SEP,2017,INTERNATIONAL FLIGHTS,137,129,266
18,SEP,2017,INTERNATIONAL FLIGHTS,115,115,230
19,SEP,2017,INTERNATIONAL FLIGHTS,85,92,177
20,SEP,2017,INTERNATIONAL FLIGHTS,132,124,256
21,SEP,2017,INTERNATIONAL FLIGHTS,94,98,192
22,SEP,2017,INTERNATIONAL FLIGHTS,108,101,209
23,SEP,2017,INTERNATIONAL FLIGHTS,123,121,244
24,SEP,2017,INTERNATIONAL FLIGHTS,128,130,258
25,SEP,2017,INTERNATIONAL FLIGHTS,113,113,226
26,SEP,2017,INTERNATIONAL FLIGHTS,80,81,161
27,SEP,2017,INTERNATIONAL FLIGHTS,119,116,235
28,SEP,2017,INTERNATIONAL FLIGHTS,103,103,206
29,SEP,2017,INTERNATIONAL FLIGHTS,104,102,206
30,SEP,2017,INTERNATIONAL FLIGHTS,100,98,198
1,SEP,2017,LOCAL FLIGHTS,12,12,24
2,SEP,2017,LOCAL FLIGHTS,13,13,26
3,SEP,2017,LOCAL FLIGHTS,2,2,4
4,SEP,2017,LOCAL FLIGHTS,8,8,16
5,SEP,2017,LOCAL FLIGHTS,16,17,33
6,SEP,2017,LOCAL FLIGHTS,6,6,12
7,SEP,2017,LOCAL FLIGHTS,9,9,18
8,SEP,2017,LOCAL FLIGHTS,11,11,22
9,SEP,2017,LOCAL FLIGHTS,11,11,22
10,SEP,2017,LOCAL FLIGHTS,0,0,0
11,SEP,2017,LOCAL FLIGHTS,6,6,12
12,SEP,2017,LOCAL FLIGHTS,7,7,14
13,SEP,2017,LOCAL FLIGHTS,4,4,8
14,SEP,2017,LOCAL FLIGHTS,11,11,22
15,SEP,2017,LOCAL FLIGHTS,11,11,22
16,SEP,2017,LOCAL FLIGHTS,14,14,28
17,SEP,2017,LOCAL FLIGHTS,3,3,6
18,SEP,2017,LOCAL FLIGHTS,10,10,20
19,SEP,2017,LOCAL FLIGHTS,14,14,28
20,SEP,2017,LOCAL FLIGHTS,6,6,12
21,SEP,2017,LOCAL FLIGHTS,9,9,18
22,SEP,2017,LOCAL FLIGHTS,15,15,30
23,SEP,2017,LOCAL FLIGHTS,14,14,28
24,SEP,2017,LOCAL FLIGHTS,5,5,10
25,SEP,2017,LOCAL FLIGHTS,15,15,30
26,SEP,2017,LOCAL FLIGHTS,8,7,15
27,SEP,2017,LOCAL FLIGHTS,8,8,16
28,SEP,2017,LOCAL FLIGHTS,12,12,24
29,SEP,2017,LOCAL FLIGHTS,7,7,14
30,SEP,2017,LOCAL FLIGHTS,12,19,31
1,SEP,2017,HELICOPTER FLIGHTS,2,2,4
2,SEP,2017,HELICOPTER FLIGHTS,1,1,2
3,SEP,2017,HELICOPTER FLIGHTS,0,0,0
4,SEP,2017,HELICOPTER FLIGHTS,3,3,6
5,SEP,2017,HELICOPTER FLIGHTS,2,2,4
6,SEP,2017,HELICOPTER FLIGHTS,3,3,6
7,SEP,2017,HELICOPTER FLIGHTS,4,5,9
8,SEP,2017,HELICOPTER FLIGHTS,4,4,8
9,SEP,2017,HELICOPTER FLIGHTS,2,2,4
10,SEP,2017,HELICOPTER FLIGHTS,2,2,4
11,SEP,2017,HELICOPTER FLIGHTS,6,6,12
12,SEP,2017,HELICOPTER FLIGHTS,3,2,5
13,SEP,2017,HELICOPTER FLIGHTS,3,3,6
14,SEP,2017,HELICOPTER FLIGHTS,1,1,2
15,SEP,2017,HELICOPTER FLIGHTS,0,0,0
16,SEP,2017,HELICOPTER FLIGHTS,0,0,0
17,SEP,2017,HELICOPTER FLIGHTS,0,0,0
18,SEP,2017,HELICOPTER FLIGHTS,2,2,4
19,SEP,2017,HELICOPTER FLIGHTS,1,1,2
20,SEP,2017,HELICOPTER FLIGHTS,1,1,2
21,SEP,2017,HELICOPTER FLIGHTS,1,1,2
22,SEP,2017,HELICOPTER FLIGHTS,1,1,2
23,SEP,2017,HELICOPTER FLIGHTS,1,1,2
24,SEP,2017,HELICOPTER FLIGHTS,0,0,0
25,SEP,2017,HELICOPTER FLIGHTS,1,2,3
26,SEP,2017,HELICOPTER FLIGHTS,1,1,2
27,SEP,2017,HELICOPTER FLIGHTS,3,3,6
28,SEP,2017,HELICOPTER FLIGHTS,2,2,4
29,SEP,2017,HELICOPTER FLIGHTS,1,1,2
30,SEP,2017,HELICOPTER FLIGHTS,0,0,0
1,OCT,2017,INTERNATIONAL FLIGHTS,128,127,255
2,OCT,2017,INTERNATIONAL FLIGHTS,119,119,238
3,OCT,2017,INTERNATIONAL FLIGHTS,86,87,173
4,OCT,2017,INTERNATIONAL FLIGHTS,123,121,244
5,OCT,2017,INTERNATIONAL FLIGHTS,102,105,207
6,OCT,2017,INTERNATIONAL FLIGHTS,113,110,223
7,OCT,2017,INTERNATIONAL FLIGHTS,103,106,209
8,OCT,2017,INTERNATIONAL FLIGHTS,135,135,270
9,OCT,2017,INTERNATIONAL FLIGHTS,120,113,233
10,OCT,2017,INTERNATIONAL FLIGHTS,82,92,174
11,OCT,2017,INTERNATIONAL FLIGHTS,113,109,222
12,OCT,2017,INTERNATIONAL FLIGHTS,103,104,207
13,OCT,2017,INTERNATIONAL FLIGHTS,108,110,218
14,OCT,2017,INTERNATIONAL FLIGHTS,112,115,227
15,OCT,2017,INTERNATIONAL FLIGHTS,134,130,264
16,OCT,2017,INTERNATIONAL FLIGHTS,111,108,219
17,OCT,2017,INTERNATIONAL FLIGHTS,77,78,155
18,OCT,2017,INTERNATIONAL FLIGHTS,107,104,211
19,OCT,2017,INTERNATIONAL FLIGHTS,97,96,193
20,OCT,2017,INTERNATIONAL FLIGHTS,96,96,192
21,OCT,2017,INTERNATIONAL FLIGHTS,112,111,223
22,OCT,2017,INTERNATIONAL FLIGHTS,112,113,225
23,OCT,2017,INTERNATIONAL FLIGHTS,106,101,207
24,OCT,2017,INTERNATIONAL FLIGHTS,83,82,165
25,OCT,2017,INTERNATIONAL FLIGHTS,109,110,219
26,OCT,2017,INTERNATIONAL FLIGHTS,91,93,184
27,OCT,2017,INTERNATIONAL FLIGHTS,101,98,199
28,OCT,2017,INTERNATIONAL FLIGHTS,105,111,216
29,OCT,2017,INTERNATIONAL FLIGHTS,100,105,205
30,OCT,2017,INTERNATIONAL FLIGHTS,85,83,168
31,OCT,2017,INTERNATIONAL FLIGHTS,57,62,119
1,OCT,2017,LOCAL FLIGHTS,6,6,12
2,OCT,2017,LOCAL FLIGHTS,9,9,18
3,OCT,2017,LOCAL FLIGHTS,13,13,26
4,OCT,2017,LOCAL FLIGHTS,12,12,24
5,OCT,2017,LOCAL FLIGHTS,16,16,32
6,OCT,2017,LOCAL FLIGHTS,12,12,24
7,OCT,2017,LOCAL FLIGHTS,8,8,16
8,OCT,2017,LOCAL FLIGHTS,4,4,8
9,OCT,2017,LOCAL FLIGHTS,9,9,18
10,OCT,2017,LOCAL FLIGHTS,7,7,14
11,OCT,2017,LOCAL FLIGHTS,18,18,36
12,OCT,2017,LOCAL FLIGHTS,14,14,28
13,OCT,2017,LOCAL FLIGHTS,8,8,16
14,OCT,2017,LOCAL FLIGHTS,13,13,26
15,OCT,2017,LOCAL FLIGHTS,2,2,4
16,OCT,2017,LOCAL FLIGHTS,11,11,22
17,OCT,2017,LOCAL FLIGHTS,10,10,20
18,OCT,2017,LOCAL FLIGHTS,13,13,26
19,OCT,2017,LOCAL FLIGHTS,16,16,32
20,OCT,2017,LOCAL FLIGHTS,16,16,32
21,OCT,2017,LOCAL FLIGHTS,15,15,30
22,OCT,2017,LOCAL FLIGHTS,3,3,6
23,OCT,2017,LOCAL FLIGHTS,10,10,20
24,OCT,2017,LOCAL FLIGHTS,18,18,36
25,OCT,2017,LOCAL FLIGHTS,14,14,28
26,OCT,2017,LOCAL FLIGHTS,12,12,24
27,OCT,2017,LOCAL FLIGHTS,10,10,20
28,OCT,2017,LOCAL FLIGHTS,4,5,9
29,OCT,2017,LOCAL FLIGHTS,0,0,0
30,OCT,2017,LOCAL FLIGHTS,12,12,24
31,OCT,2017,LOCAL FLIGHTS,11,11,22
1,OCT,2017,HELICOPTER FLIGHTS,0,0,0
2,OCT,2017,HELICOPTER FLIGHTS,1,1,2
3,OCT,2017,HELICOPTER FLIGHTS,2,3,5
4,OCT,2017,HELICOPTER FLIGHTS,6,6,12
5,OCT,2017,HELICOPTER FLIGHTS,0,0,0
6,OCT,2017,HELICOPTER FLIGHTS,1,1,2
7,OCT,2017,HELICOPTER FLIGHTS,0,0,0
8,OCT,2017,HELICOPTER FLIGHTS,0,0,0
9,OCT,2017,HELICOPTER FLIGHTS,1,1,2
10,OCT,2017,HELICOPTER FLIGHTS,1,1,2
11,OCT,2017,HELICOPTER FLIGHTS,0,0,0
12,OCT,2017,HELICOPTER FLIGHTS,2,2,4
13,OCT,2017,HELICOPTER FLIGHTS,1,1,2
14,OCT,2017,HELICOPTER FLIGHTS,1,1,2
15,OCT,2017,HELICOPTER FLIGHTS,1,1,2
16,OCT,2017,HELICOPTER FLIGHTS,3,4,7
17,OCT,2017,HELICOPTER FLIGHTS,4,4,8
18,OCT,2017,HELICOPTER FLIGHTS,1,1,2
19,OCT,2017,HELICOPTER FLIGHTS,1,1,2
20,OCT,2017,HELICOPTER FLIGHTS,2,2,4
21,OCT,2017,HELICOPTER FLIGHTS,0,0,0
22,OCT,2017,HELICOPTER FLIGHTS,0,0,0
23,OCT,2017,HELICOPTER FLIGHTS,2,2,4
24,OCT,2017,HELICOPTER FLIGHTS,1,1,2
25,OCT,2017,HELICOPTER FLIGHTS,1,1,2
26,OCT,2017,HELICOPTER FLIGHTS,1,1,2
27,OCT,2017,HELICOPTER FLIGHTS,1,1,2
28,OCT,2017,HELICOPTER FLIGHTS,0,0,0
29,OCT,2017,HELICOPTER FLIGHTS,0,0,0
30,OCT,2017,HELICOPTER FLIGHTS,0,0,0
31,OCT,2017,HELICOPTER FLIGHTS,2,2,4
1,NOV,2017,INTERNATIONAL FLIGHTS,80,77,157
2,NOV,2017,INTERNATIONAL FLIGHTS,73,72,145
3,NOV,2017,INTERNATIONAL FLIGHTS,80,81,161
4,NOV,2017,INTERNATIONAL FLIGHTS,83,83,166
5,NOV,2017,INTERNATIONAL FLIGHTS,79,79,158
6,NOV,2017,INTERNATIONAL FLIGHTS,77,75,152
7,NOV,2017,INTERNATIONAL FLIGHTS,52,57,109
8,NOV,2017,INTERNATIONAL FLIGHTS,69,65,134
9,NOV,2017,INTERNATIONAL FLIGHTS,64,70,134
10,NOV,2017,INTERNATIONAL FLIGHTS,64,61,125
11,NOV,2017,INTERNATIONAL FLIGHTS,61,61,122
12,NOV,2017,INTERNATIONAL FLIGHTS,68,65,133
13,NOV,2017,INTERNATIONAL FLIGHTS,62,62,124
14,NOV,2017,INTERNATIONAL FLIGHTS,49,52,101
15,NOV,2017,INTERNATIONAL FLIGHTS,64,48,112
16,NOV,2017,INTERNATIONAL FLIGHTS,67,67,134
17,NOV,2017,INTERNATIONAL FLIGHTS,69,71,140
18,NOV,2017,INTERNATIONAL FLIGHTS,54,58,112
19,NOV,2017,INTERNATIONAL FLIGHTS,67,63,130
20,NOV,2017,INTERNATIONAL FLIGHTS,67,65,132
21,NOV,2017,INTERNATIONAL FLIGHTS,54,53,107
22,NOV,2017,INTERNATIONAL FLIGHTS,55,59,114
23,NOV,2017,INTERNATIONAL FLIGHTS,58,58,116
24,NOV,2017,INTERNATIONAL FLIGHTS,65,65,130
25,NOV,2017,INTERNATIONAL FLIGHTS,57,50,107
26,NOV,2017,INTERNATIONAL FLIGHTS,61,63,124
27,NOV,2017,INTERNATIONAL FLIGHTS,58,57,115
28,NOV,2017,INTERNATIONAL FLIGHTS,46,48,94
29,NOV,2017,INTERNATIONAL FLIGHTS,57,55,112
30,NOV,2017,INTERNATIONAL FLIGHTS,64,60,124
1,NOV,2017,LOCAL FLIGHTS,7,7,14
2,NOV,2017,LOCAL FLIGHTS,7,7,14
3,NOV,2017,LOCAL FLIGHTS,7,7,14
4,NOV,2017,LOCAL FLIGHTS,11,11,22
5,NOV,2017,LOCAL FLIGHTS,0,0,0
6,NOV,2017,LOCAL FLIGHTS,14,14,28
7,NOV,2017,LOCAL FLIGHTS,16,16,32
8,NOV,2017,LOCAL FLIGHTS,12,12,24
9,NOV,2017,LOCAL FLIGHTS,16,16,32
10,NOV,2017,LOCAL FLIGHTS,11,11,22
11,NOV,2017,LOCAL FLIGHTS,19,19,38
12,NOV,2017,LOCAL FLIGHTS,5,5,10
13,NOV,2017,LOCAL FLIGHTS,11,11,22
14,NOV,2017,LOCAL FLIGHTS,14,14,28
15,NOV,2017,LOCAL FLIGHTS,19,19,38
16,NOV,2017,LOCAL FLIGHTS,15,15,30
17,NOV,2017,LOCAL FLIGHTS,15,15,30
18,NOV,2017,LOCAL FLIGHTS,12,12,24
19,NOV,2017,LOCAL FLIGHTS,3,3,6
20,NOV,2017,LOCAL FLIGHTS,8,8,16
21,NOV,2017,LOCAL FLIGHTS,5,5,10
22,NOV,2017,LOCAL FLIGHTS,16,16,32
23,NOV,2017,LOCAL FLIGHTS,19,19,38
24,NOV,2017,LOCAL FLIGHTS,6,6,12
25,NOV,2017,LOCAL FLIGHTS,8,8,16
26,NOV,2017,LOCAL FLIGHTS,1,1,2
27,NOV,2017,LOCAL FLIGHTS,10,10,20
28,NOV,2017,LOCAL FLIGHTS,1,1,2
29,NOV,2017,LOCAL FLIGHTS,5,5,10
30,NOV,2017,LOCAL FLIGHTS,9,9,18
1,NOV,2017,HELICOPTER FLIGHTS,2,2,4
2,NOV,2017,HELICOPTER FLIGHTS,2,2,4
3,NOV,2017,HELICOPTER FLIGHTS,2,2,4
4,NOV,2017,HELICOPTER FLIGHTS,0,0,0
5,NOV,2017,HELICOPTER FLIGHTS,0,0,0
6,NOV,2017,HELICOPTER FLIGHTS,1,1,2
7,NOV,2017,HELICOPTER FLIGHTS,1,1,2
8,NOV,2017,HELICOPTER FLIGHTS,1,1,2
9,NOV,2017,HELICOPTER FLIGHTS,1,1,2
10,NOV,2017,HELICOPTER FLIGHTS,0,0,0
11,NOV,2017,HELICOPTER FLIGHTS,1,1,2
12,NOV,2017,HELICOPTER FLIGHTS,2,3,5
13,NOV,2017,HELICOPTER FLIGHTS,0,0,0
14,NOV,2017,HELICOPTER FLIGHTS,1,1,2
15,NOV,2017,HELICOPTER FLIGHTS,1,1,2
16,NOV,2017,HELICOPTER FLIGHTS,0,0,0
17,NOV,2017,HELICOPTER FLIGHTS,1,1,2
18,NOV,2017,HELICOPTER FLIGHTS,1,1,2
19,NOV,2017,HELICOPTER FLIGHTS,0,0,0
20,NOV,2017,HELICOPTER FLIGHTS,5,5,10
21,NOV,2017,HELICOPTER FLIGHTS,1,1,2
22,NOV,2017,HELICOPTER FLIGHTS,0,0,0
23,NOV,2017,HELICOPTER FLIGHTS,0,0,0
24,NOV,2017,HELICOPTER FLIGHTS,0,0,0
25,NOV,2017,HELICOPTER FLIGHTS,0,0,0
26,NOV,2017,HELICOPTER FLIGHTS,0,0,0
27,NOV,2017,HELICOPTER FLIGHTS,1,1,2
28,NOV,2017,HELICOPTER FLIGHTS,0,0,0
29,NOV,2017,HELICOPTER FLIGHTS,1,1,2
30,NOV,2017,HELICOPTER FLIGHTS,2,2,4
1,DEC,2017,INTERNATIONAL FLIGHTS,64,63,127
2,DEC,2017,INTERNATIONAL FLIGHTS,54,56,110
3,DEC,2017,INTERNATIONAL FLIGHTS,60,60,120
4,DEC,2017,INTERNATIONAL FLIGHTS,60,57,117
5,DEC,2017,INTERNATIONAL FLIGHTS,53,52,105
6,DEC,2017,INTERNATIONAL FLIGHTS,58,63,121
7,DEC,2017,INTERNATIONAL FLIGHTS,68,64,132
8,DEC,2017,INTERNATIONAL FLIGHTS,63,60,123
9,DEC,2017,INTERNATIONAL FLIGHTS,46,43,89
10,DEC,2017,INTERNATIONAL FLIGHTS,58,57,115
11,DEC,2017,INTERNATIONAL FLIGHTS,58,57,115
12,DEC,2017,INTERNATIONAL FLIGHTS,46,48,94
13,DEC,2017,INTERNATIONAL FLIGHTS,56,54,110
14,DEC,2017,INTERNATIONAL FLIGHTS,59,60,119
15,DEC,2017,INTERNATIONAL FLIGHTS,59,61,120
16,DEC,2017,INTERNATIONAL FLIGHTS,52,53,105
17,DEC,2017,INTERNATIONAL FLIGHTS,62,58,120
18,DEC,2017,INTERNATIONAL FLIGHTS,57,57,114
19,DEC,2017,INTERNATIONAL FLIGHTS,48,49,97
20,DEC,2017,INTERNATIONAL FLIGHTS,57,58,115
21,DEC,2017,INTERNATIONAL FLIGHTS,61,59,120
22,DEC,2017,INTERNATIONAL FLIGHTS,58,63,121
23,DEC,2017,INTERNATIONAL FLIGHTS,52,54,106
24,DEC,2017,INTERNATIONAL FLIGHTS,52,51,103
25,DEC,2017,INTERNATIONAL FLIGHTS,27,26,53
26,DEC,2017,INTERNATIONAL FLIGHTS,44,43,87
27,DEC,2017,INTERNATIONAL FLIGHTS,63,64,127
28,DEC,2017,INTERNATIONAL FLIGHTS,56,56,112
29,DEC,2017,INTERNATIONAL FLIGHTS,63,74,137
30,DEC,2017,INTERNATIONAL FLIGHTS,52,53,105
31,DEC,2017,INTERNATIONAL FLIGHTS,52,53,105
1,DEC,2017,LOCAL FLIGHTS,13,13,26
2,DEC,2017,LOCAL FLIGHTS,9,9,18
3,DEC,2017,LOCAL FLIGHTS,8,8,16
4,DEC,2017,LOCAL FLIGHTS,5,5,10
5,DEC,2017,LOCAL FLIGHTS,4,4,8
6,DEC,2017,LOCAL FLIGHTS,2,2,4
7,DEC,2017,LOCAL FLIGHTS,15,15,30
8,DEC,2017,LOCAL FLIGHTS,23,23,46
9,DEC,2017,LOCAL FLIGHTS,21,21,42
10,DEC,2017,LOCAL FLIGHTS,1,1,2
11,DEC,2017,LOCAL FLIGHTS,10,10,20
12,DEC,2017,LOCAL FLIGHTS,10,10,20
13,DEC,2017,LOCAL FLIGHTS,15,15,30
14,DEC,2017,LOCAL FLIGHTS,17,17,34
15,DEC,2017,LOCAL FLIGHTS,12,12,24
16,DEC,2017,LOCAL FLIGHTS,9,9,18
17,DEC,2017,LOCAL FLIGHTS,2,2,4
18,DEC,2017,LOCAL FLIGHTS,10,10,20
19,DEC,2017,LOCAL FLIGHTS,17,17,34
20,DEC,2017,LOCAL FLIGHTS,17,17,34
21,DEC,2017,LOCAL FLIGHTS,6,6,12
22,DEC,2017,LOCAL FLIGHTS,3,3,6
23,DEC,2017,LOCAL FLIGHTS,2,2,4
24,DEC,2017,LOCAL FLIGHTS,1,1,2
25,DEC,2017,LOCAL FLIGHTS,1,1,2
26,DEC,2017,LOCAL FLIGHTS,5,5,10
27,DEC,2017,LOCAL FLIGHTS,15,15,30
28,DEC,2017,LOCAL FLIGHTS,17,17,34
29,DEC,2017,LOCAL FLIGHTS,14,14,28
30,DEC,2017,LOCAL FLIGHTS,33,33,66
31,DEC,2017,LOCAL FLIGHTS,0,0,0
1,DEC,2017,HELICOPTER FLIGHTS,2,2,4
2,DEC,2017,HELICOPTER FLIGHTS,0,0,0
3,DEC,2017,HELICOPTER FLIGHTS,0,0,0
4,DEC,2017,HELICOPTER FLIGHTS,1,1,2
5,DEC,2017,HELICOPTER FLIGHTS,1,1,2
6,DEC,2017,HELICOPTER FLIGHTS,0,0,0
7,DEC,2017,HELICOPTER FLIGHTS,1,1,2
8,DEC,2017,HELICOPTER FLIGHTS,1,1,2
9,DEC,2017,HELICOPTER FLIGHTS,1,1,2
10,DEC,2017,HELICOPTER FLIGHTS,0,0,0
11,DEC,2017,HELICOPTER FLIGHTS,1,1,2
12,DEC,2017,HELICOPTER FLIGHTS,2,1,3
13,DEC,2017,HELICOPTER FLIGHTS,2,2,4
14,DEC,2017,HELICOPTER FLIGHTS,4,4,8
15,DEC,2017,HELICOPTER FLIGHTS,2,2,4
16,DEC,2017,HELICOPTER FLIGHTS,0,0,0
17,DEC,2017,HELICOPTER FLIGHTS,0,0,0
18,DEC,2017,HELICOPTER FLIGHTS,2,2,4
19,DEC,2017,HELICOPTER FLIGHTS,0,0,0
20,DEC,2017,HELICOPTER FLIGHTS,1,1,2
21,DEC,2017,HELICOPTER FLIGHTS,2,1,3
22,DEC,2017,HELICOPTER FLIGHTS,1,1,2
23,DEC,2017,HELICOPTER FLIGHTS,1,0,1
24,DEC,2017,HELICOPTER FLIGHTS,0,0,0
25,DEC,2017,HELICOPTER FLIGHTS,0,0,0
26,DEC,2017,HELICOPTER FLIGHTS,2,2,4
27,DEC,2017,HELICOPTER FLIGHTS,2,2,4
28,DEC,2017,HELICOPTER FLIGHTS,5,5,10
29,DEC,2017,HELICOPTER FLIGHTS,4,4,8
30,DEC,2017,HELICOPTER FLIGHTS,3,3,6
31,DEC,2017,HELICOPTER FLIGHTS,1,1,2
