DAY,MONTH,YEAR,FLIGHT_CATEGORY,INBOUND_FLIGHTS,OUTBOUND_FLIGHTS,TOTAL_FLIGHTS
1,JAN,2017,INTERNATIONAL FLIGHTS,11,11,22
2,JAN,2017,INTERNATIONAL FLIGHTS,6,6,12
3,JAN,2017,INTERNATIONAL FLIGHTS,10,10,20
4,JAN,2017,INTERNATIONAL FLIGHTS,19,18,37
5,JAN,2017,INTERNATIONAL FLIGHTS,11,11,22
6,JAN,2017,INTERNATIONAL FLIGHTS,9,8,17
7,JAN,2017,INTERNATIONAL FLIGHTS,11,13,24
8,JAN,2017,INTERNATIONAL FLIGHTS,14,14,28
9,JAN,2017,INTERNATIONAL FLIGHTS,7,6,13
10,JAN,2017,INTERNATIONAL FLIGHTS,4,6,10
11,JAN,2017,INTERNATIONAL FLIGHTS,18,15,33
12,JAN,2017,INTERNATIONAL FLIGHTS,7,7,14
13,JAN,2017,INTERNATIONAL FLIGHTS,10,9,19
14,JAN,2017,INTERNATIONAL FLIGHTS,10,12,22
15,JAN,2017,INTERNATIONAL FLIGHTS,9,11,20
16,JAN,2017,INTERNATIONAL FLIGHTS,8,7,15
17,JAN,2017,INTERNATIONAL FLIGHTS,6,4,10
18,JAN,2017,INTERNATIONAL FLIGHTS,12,14,26
19,JAN,2017,INTERNATIONAL FLIGHTS,8,5,13
20,JAN,2017,INTERNATIONAL FLIGHTS,13,12,25
21,JAN,2017,INTERNATIONAL FLIGHTS,12,15,27
22,JAN,2017,INTERNATIONAL FLIGHTS,16,12,28
23,JAN,2017,INTERNATIONAL FLIGHTS,6,9,15
24,JAN,2017,INTERNATIONAL FLIGHTS,5,4,9
25,JAN,2017,INTERNATIONAL FLIGHTS,11,10,21
26,JAN,2017,INTERNATIONAL FLIGHTS,7,8,15
27,JAN,2017,INTERNATIONAL FLIGHTS,5,6,11
28,JAN,2017,INTERNATIONAL FLIGHTS,14,12,26
29,JAN,2017,INTERNATIONAL FLIGHTS,15,15,30
30,JAN,2017,INTERNATIONAL FLIGHTS,8,7,15
31,JAN,2017,INTERNATIONAL FLIGHTS,5,4,9
1,JAN,2017,LOCAL FLIGHTS,0,0,0
2,JAN,2017,LOCAL FLIGHTS,2,2,4
3,JAN,2017,LOCAL FLIGHTS,1,1,2
4,JAN,2017,LOCAL FLIGHTS,3,3,6
5,JAN,2017,LOCAL FLIGHTS,1,1,2
6,JAN,2017,LOCAL FLIGHTS,0,1,1
7,JAN,2017,LOCAL FLIGHTS,4,4,8
8,JAN,2017,LOCAL FLIGHTS,0,0,0
9,JAN,2017,LOCAL FLIGHTS,1,1,2
10,JAN,2017,LOCAL FLIGHTS,0,0,0
11,JAN,2017,LOCAL FLIGHTS,6,6,12
12,JAN,2017,LOCAL FLIGHTS,5,5,10
13,JAN,2017,LOCAL FLIGHTS,2,2,4
14,JAN,2017,LOCAL FLIGHTS,3,3,6
15,JAN,2017,LOCAL FLIGHTS,0,0,0
16,JAN,2017,LOCAL FLIGHTS,2,2,4
17,JAN,2017,LOCAL FLIGHTS,4,4,8
18,JAN,2017,LOCAL FLIGHTS,1,2,3
19,JAN,2017,LOCAL FLIGHTS,4,5,9
20,JAN,2017,LOCAL FLIGHTS,3,3,6
21,JAN,2017,LOCAL FLIGHTS,3,3,6
22,JAN,2017,LOCAL FLIGHTS,0,0,0
23,JAN,2017,LOCAL FLIGHTS,1,1,2
24,JAN,2017,LOCAL FLIGHTS,1,1,2
25,JAN,2017,LOCAL FLIGHTS,3,3,6
26,JAN,2017,LOCAL FLIGHTS,2,1,3
27,JAN,2017,LOCAL FLIGHTS,1,1,2
28,JAN,2017,LOCAL FLIGHTS,1,1,2
29,JAN,2017,LOCAL FLIGHTS,1,1,2
30,JAN,2017,LOCAL FLIGHTS,0,0,0
31,JAN,2017,LOCAL FLIGHTS,0,0,0
1,JAN,2017,HELICOPTER FLIGHTS,0,0,0
2,JAN,2017,HELICOPTER FLIGHTS,0,0,0
3,JAN,2017,HELICOPTER FLIGHTS,4,4,8
4,JAN,2017,HELICOPTER FLIGHTS,4,4,8
5,JAN,2017,HELICOPTER FLIGHTS,2,2,4
6,JAN,2017,HELICOPTER FLIGHTS,0,0,0
7,JAN,2017,HELICOPTER FLIGHTS,0,0,0
8,JAN,2017,HELICOPTER FLIGHTS,0,0,0
9,JAN,2017,HELICOPTER FLIGHTS,6,6,12
10,JAN,2017,HELICOPTER FLIGHTS,2,2,4
11,JAN,2017,HELICOPTER FLIGHTS,8,8,16
12,JAN,2017,HELICOPTER FLIGHTS,17,17,34
13,JAN,2017,HELICOPTER FLIGHTS,1,1,2
14,JAN,2017,HELICOPTER FLIGHTS,0,0,0
15,JAN,2017,HELICOPTER FLIGHTS,0,0,0
16,JAN,2017,HELICOPTER FLIGHTS,6,6,12
17,JAN,2017,HELICOPTER FLIGHTS,4,4,8
18,JAN,2017,HELICOPTER FLIGHTS,8,8,16
19,JAN,2017,HELICOPTER FLIGHTS,10,10,20
20,JAN,2017,HELICOPTER FLIGHTS,3,3,6
21,JAN,2017,HELICOPTER FLIGHTS,0,0,0
22,JAN,2017,HELICOPTER FLIGHTS,0,0,0
23,JAN,2017,HELICOPTER FLIGHTS,2,2,4
24,JAN,2017,HELICOPTER FLIGHTS,7,7,14
25,JAN,2017,HELICOPTER FLIGHTS,4,4,8
26,JAN,2017,HELICOPTER FLIGHTS,7,7,14
27,JAN,2017,HELICOPTER FLIGHTS,0,0,0
28,JAN,2017,HELICOPTER FLIGHTS,0,0,0
29,JAN,2017,HELICOPTER FLIGHTS,0,0,0
30,JAN,2017,HELICOPTER FLIGHTS,6,6,12
31,JAN,2017,HELICOPTER FLIGHTS,12,12,24
1,FEB,2017,INTERNATIONAL FLIGHTS,12,12,24
2,FEB,2017,INTERNATIONAL FLIGHTS,9,7,16
3,FEB,2017,INTERNATIONAL FLIGHTS,6,12,18
4,FEB,2017,INTERNATIONAL FLIGHTS,12,12,24
5,FEB,2017,INTERNATIONAL FLIGHTS,13,13,26
6,FEB,2017,INTERNATIONAL FLIGHTS,10,9,19
7,FEB,2017,INTERNATIONAL FLIGHTS,7,9,16
8,FEB,2017,INTERNATIONAL FLIGHTS,14,13,27
9,FEB,2017,INTERNATIONAL FLIGHTS,8,9,17
10,FEB,2017,INTERNATIONAL FLIGHTS,11,11,22
11,FEB,2017,INTERNATIONAL FLIGHTS,15,15,30
12,FEB,2017,INTERNATIONAL FLIGHTS,14,14,28
13,FEB,2017,INTERNATIONAL FLIGHTS,7,8,15
14,FEB,2017,INTERNATIONAL FLIGHTS,6,6,12
15,FEB,2017,INTERNATIONAL FLIGHTS,16,15,31
16,FEB,2017,INTERNATIONAL FLIGHTS,11,9,20
17,FEB,2017,INTERNATIONAL FLIGHTS,9,10,19
18,FEB,2017,INTERNATIONAL FLIGHTS,15,16,31
19,FEB,2017,INTERNATIONAL FLIGHTS,16,16,32
20,FEB,2017,INTERNATIONAL FLIGHTS,7,7,14
21,FEB,2017,INTERNATIONAL FLIGHTS,9,6,15
22,FEB,2017,INTERNATIONAL FLIGHTS,23,26,49
23,FEB,2017,INTERNATIONAL FLIGHTS,11,9,20
24,FEB,2017,INTERNATIONAL FLIGHTS,13,11,24
25,FEB,2017,INTERNATIONAL FLIGHTS,15,17,32
26,FEB,2017,INTERNATIONAL FLIGHTS,14,15,29
27,FEB,2017,INTERNATIONAL FLIGHTS,7,6,13
28,FEB,2017,INTERNATIONAL FLIGHTS,7,8,15
1,FEB,2017,LOCAL FLIGHTS,3,3,6
2,FEB,2017,LOCAL FLIGHTS,1,1,2
3,FEB,2017,LOCAL FLIGHTS,2,2,4
4,FEB,2017,LOCAL FLIGHTS,2,2,4
5,FEB,2017,LOCAL FLIGHTS,2,2,4
6,FEB,2017,LOCAL FLIGHTS,2,2,4
7,FEB,2017,LOCAL FLIGHTS,0,0,0
8,FEB,2017,LOCAL FLIGHTS,2,2,4
9,FEB,2017,LOCAL FLIGHTS,2,2,4
10,FEB,2017,LOCAL FLIGHTS,3,3,6
11,FEB,2017,LOCAL FLIGHTS,3,3,6
12,FEB,2017,LOCAL FLIGHTS,0,0,0
13,FEB,2017,LOCAL FLIGHTS,4,4,8
14,FEB,2017,LOCAL FLIGHTS,1,2,3
15,FEB,2017,LOCAL FLIGHTS,4,3,7
16,FEB,2017,LOCAL FLIGHTS,0,0,0
17,FEB,2017,LOCAL FLIGHTS,2,2,4
18,FEB,2017,LOCAL FLIGHTS,3,2,5
19,FEB,2017,LOCAL FLIGHTS,0,0,0
20,FEB,2017,LOCAL FLIGHTS,5,5,10
21,FEB,2017,LOCAL FLIGHTS,0,0,0
22,FEB,2017,LOCAL FLIGHTS,2,2,4
23,FEB,2017,LOCAL FLIGHTS,1,1,2
24,FEB,2017,LOCAL FLIGHTS,4,4,8
25,FEB,2017,LOCAL FLIGHTS,5,5,10
26,FEB,2017,LOCAL FLIGHTS,0,0,0
27,FEB,2017,LOCAL FLIGHTS,0,0,0
28,FEB,2017,LOCAL FLIGHTS,4,4,8
1,FEB,2017,HELICOPTER FLIGHTS,7,7,14
2,FEB,2017,HELICOPTER FLIGHTS,11,11,22
3,FEB,2017,HELICOPTER FLIGHTS,1,1,2
4,FEB,2017,HELICOPTER FLIGHTS,1,1,2
5,FEB,2017,HELICOPTER FLIGHTS,0,0,0
6,FEB,2017,HELICOPTER FLIGHTS,6,6,12
7,FEB,2017,HELICOPTER FLIGHTS,8,8,16
8,FEB,2017,HELICOPTER FLIGHTS,6,6,12
9,FEB,2017,HELICOPTER FLIGHTS,16,16,32
10,FEB,2017,HELICOPTER FLIGHTS,2,2,4
11,FEB,2017,HELICOPTER FLIGHTS,0,0,0
12,FEB,2017,HELICOPTER FLIGHTS,0,0,0
13,FEB,2017,HELICOPTER FLIGHTS,6,6,12
14,FEB,2017,HELICOPTER FLIGHTS,6,6,12
15,FEB,2017,HELICOPTER FLIGHTS,5,5,10
16,FEB,2017,HELICOPTER FLIGHTS,0,0,0
17,FEB,2017,HELICOPTER FLIGHTS,0,0,0
18,FEB,2017,HELICOPTER FLIGHTS,2,2,4
19,FEB,2017,HELICOPTER FLIGHTS,2,2,4
20,FEB,2017,HELICOPTER FLIGHTS,6,6,12
21,FEB,2017,HELICOPTER FLIGHTS,3,3,6
22,FEB,2017,HELICOPTER FLIGHTS,1,1,2
23,FEB,2017,HELICOPTER FLIGHTS,11,11,22
24,FEB,2017,HELICOPTER FLIGHTS,2,2,4
25,FEB,2017,HELICOPTER FLIGHTS,0,0,0
26,FEB,2017,HELICOPTER FLIGHTS,1,1,2
27,FEB,2017,HELICOPTER FLIGHTS,0,0,0
28,FEB,2017,HELICOPTER FLIGHTS,7,7,14
1,MAR,2017,INTERNATIONAL FLIGHTS,30,28,58
2,MAR,2017,INTERNATIONAL FLIGHTS,10,11,21
3,MAR,2017,INTERNATIONAL FLIGHTS,9,8,17
4,MAR,2017,INTERNATIONAL FLIGHTS,13,14,27
5,MAR,2017,INTERNATIONAL FLIGHTS,16,14,30
6,MAR,2017,INTERNATIONAL FLIGHTS,8,7,15
7,MAR,2017,INTERNATIONAL FLIGHTS,7,8,15
8,MAR,2017,INTERNATIONAL FLIGHTS,29,30,59
9,MAR,2017,INTERNATIONAL FLIGHTS,9,11,20
10,MAR,2017,INTERNATIONAL FLIGHTS,9,9,18
11,MAR,2017,INTERNATIONAL FLIGHTS,16,16,32
12,MAR,2017,INTERNATIONAL FLIGHTS,11,12,23
13,MAR,2017,INTERNATIONAL FLIGHTS,9,8,17
14,MAR,2017,INTERNATIONAL FLIGHTS,9,9,18
15,MAR,2017,INTERNATIONAL FLIGHTS,27,29,56
16,MAR,2017,INTERNATIONAL FLIGHTS,13,11,24
17,MAR,2017,INTERNATIONAL FLIGHTS,8,10,18
18,MAR,2017,INTERNATIONAL FLIGHTS,20,17,37
19,MAR,2017,INTERNATIONAL FLIGHTS,12,15,27
20,MAR,2017,INTERNATIONAL FLIGHTS,8,6,14
21,MAR,2017,INTERNATIONAL FLIGHTS,11,10,21
22,MAR,2017,INTERNATIONAL FLIGHTS,33,33,66
23,MAR,2017,INTERNATIONAL FLIGHTS,14,13,27
24,MAR,2017,INTERNATIONAL FLIGHTS,11,10,21
25,MAR,2017,INTERNATIONAL FLIGHTS,20,21,41
26,MAR,2017,INTERNATIONAL FLIGHTS,20,19,39
27,MAR,2017,INTERNATIONAL FLIGHTS,13,14,27
28,MAR,2017,INTERNATIONAL FLIGHTS,16,14,30
29,MAR,2017,INTERNATIONAL FLIGHTS,37,39,76
30,MAR,2017,INTERNATIONAL FLIGHTS,17,14,31
31,MAR,2017,INTERNATIONAL FLIGHTS,15,17,32
1,MAR,2017,LOCAL FLIGHTS,4,4,8
2,MAR,2017,LOCAL FLIGHTS,5,5,10
3,MAR,2017,LOCAL FLIGHTS,2,2,4
4,MAR,2017,LOCAL FLIGHTS,4,4,8
5,MAR,2017,LOCAL FLIGHTS,0,0,0
6,MAR,2017,LOCAL FLIGHTS,6,6,12
7,MAR,2017,LOCAL FLIGHTS,3,3,6
8,MAR,2017,LOCAL FLIGHTS,3,3,6
9,MAR,2017,LOCAL FLIGHTS,3,3,6
10,MAR,2017,LOCAL FLIGHTS,2,2,4
11,MAR,2017,LOCAL FLIGHTS,3,3,6
12,MAR,2017,LOCAL FLIGHTS,0,0,0
13,MAR,2017,LOCAL FLIGHTS,1,1,2
14,MAR,2017,LOCAL FLIGHTS,2,2,4
15,MAR,2017,LOCAL FLIGHTS,2,2,4
16,MAR,2017,LOCAL FLIGHTS,3,3,6
17,MAR,2017,LOCAL FLIGHTS,3,3,6
18,MAR,2017,LOCAL FLIGHTS,1,2,3
19,MAR,2017,LOCAL FLIGHTS,1,1,2
20,MAR,2017,LOCAL FLIGHTS,1,1,2
21,MAR,2017,LOCAL FLIGHTS,2,2,4
22,MAR,2017,LOCAL FLIGHTS,3,3,6
23,MAR,2017,LOCAL FLIGHTS,5,5,10
24,MAR,2017,LOCAL FLIGHTS,1,1,2
25,MAR,2017,LOCAL FLIGHTS,2,2,4
26,MAR,2017,LOCAL FLIGHTS,0,0,0
27,MAR,2017,LOCAL FLIGHTS,3,3,6
28,MAR,2017,LOCAL FLIGHTS,2,2,4
29,MAR,2017,LOCAL FLIGHTS,2,2,4
30,MAR,2017,LOCAL FLIGHTS,2,2,4
31,MAR,2017,LOCAL FLIGHTS,0,0,0
1,MAR,2017,HELICOPTER FLIGHTS,7,7,14
2,MAR,2017,HELICOPTER FLIGHTS,6,6,12
3,MAR,2017,HELICOPTER FLIGHTS,1,1,2
4,MAR,2017,HELICOPTER FLIGHTS,0,0,0
5,MAR,2017,HELICOPTER FLIGHTS,0,0,0
6,MAR,2017,HELICOPTER FLIGHTS,9,9,18
7,MAR,2017,HELICOPTER FLIGHTS,7,7,14
8,MAR,2017,HELICOPTER FLIGHTS,8,8,16
9,MAR,2017,HELICOPTER FLIGHTS,5,5,10
10,MAR,2017,HELICOPTER FLIGHTS,0,0,0
11,MAR,2017,HELICOPTER FLIGHTS,1,1,2
12,MAR,2017,HELICOPTER FLIGHTS,0,0,0
13,MAR,2017,HELICOPTER FLIGHTS,2,2,4
14,MAR,2017,HELICOPTER FLIGHTS,3,3,6
15,MAR,2017,HELICOPTER FLIGHTS,9,9,18
16,MAR,2017,HELICOPTER FLIGHTS,8,8,16
17,MAR,2017,HELICOPTER FLIGHTS,0,0,0
18,MAR,2017,HELICOPTER FLIGHTS,0,0,0
19,MAR,2017,HELICOPTER FLIGHTS,0,0,0
20,MAR,2017,HELICOPTER FLIGHTS,3,3,6
21,MAR,2017,HELICOPTER FLIGHTS,0,0,0
22,MAR,2017,HELICOPTER FLIGHTS,1,1,2
23,MAR,2017,HELICOPTER FLIGHTS,15,15,30
24,MAR,2017,HELICOPTER FLIGHTS,0,2,2
25,MAR,2017,HELICOPTER FLIGHTS,0,0,0
26,MAR,2017,HELICOPTER FLIGHTS,0,0,0
27,MAR,2017,HELICOPTER FLIGHTS,4,4,8
28,MAR,2017,HELICOPTER FLIGHTS,5,5,10
29,MAR,2017,HELICOPTER FLIGHTS,2,2,4
30,MAR,2017,HELICOPTER FLIGHTS,5,5,10
31,MAR,2017,HELICOPTER FLIGHTS,0,0,0
1,APR,2017,INTERNATIONAL FLIGHTS,27,27,54
2,APR,2017,INTERNATIONAL FLIGHTS,28,28,56
3,APR,2017,INTERNATIONAL FLIGHTS,12,12,24
4,APR,2017,INTERNATIONAL FLIGHTS,15,13,28
5,APR,2017,INTERNATIONAL FLIGHTS,47,46,93
6,APR,2017,INTERNATIONAL FLIGHTS,17,18,35
7,APR,2017,INTERNATIONAL FLIGHTS,13,14,27
8,APR,2017,INTERNATIONAL FLIGHTS,27,25,52
9,APR,2017,INTERNATIONAL FLIGHTS,30,29,59
10,APR,2017,INTERNATIONAL FLIGHTS,12,13,25
11,APR,2017,INTERNATIONAL FLIGHTS,16,16,32
12,APR,2017,INTERNATIONAL FLIGHTS,46,44,90
13,APR,2017,INTERNATIONAL FLIGHTS,20,20,40
14,APR,2017,INTERNATIONAL FLIGHTS,15,16,31
15,APR,2017,INTERNATIONAL FLIGHTS,28,27,55
16,APR,2017,INTERNATIONAL FLIGHTS,30,34,64
17,APR,2017,INTERNATIONAL FLIGHTS,16,16,32
18,APR,2017,INTERNATIONAL FLIGHTS,17,17,34
19,APR,2017,INTERNATIONAL FLIGHTS,48,45,93
20,APR,2017,INTERNATIONAL FLIGHTS,20,21,41
21,APR,2017,INTERNATIONAL FLIGHTS,19,18,37
22,APR,2017,INTERNATIONAL FLIGHTS,30,32,62
23,APR,2017,INTERNATIONAL FLIGHTS,31,30,61
24,APR,2017,INTERNATIONAL FLIGHTS,16,17,33
25,APR,2017,INTERNATIONAL FLIGHTS,16,15,31
26,APR,2017,INTERNATIONAL FLIGHTS,50,48,98
27,APR,2017,INTERNATIONAL FLIGHTS,19,20,39
28,APR,2017,INTERNATIONAL FLIGHTS,23,21,44
29,APR,2017,INTERNATIONAL FLIGHTS,34,33,67
30,APR,2017,INTERNATIONAL FLIGHTS,35,35,70
1,APR,2017,LOCAL FLIGHTS,3,3,6
2,APR,2017,LOCAL FLIGHTS,0,0,0
3,APR,2017,LOCAL FLIGHTS,1,1,2
4,APR,2017,LOCAL FLIGHTS,4,4,8
5,APR,2017,LOCAL FLIGHTS,2,2,4
6,APR,2017,LOCAL FLIGHTS,4,4,8
7,APR,2017,LOCAL FLIGHTS,3,3,6
8,APR,2017,LOCAL FLIGHTS,3,3,6
9,APR,2017,LOCAL FLIGHTS,0,0,0
10,APR,2017,LOCAL FLIGHTS,5,5,10
11,APR,2017,LOCAL FLIGHTS,4,4,8
12,APR,2017,LOCAL FLIGHTS,2,2,4
13,APR,2017,LOCAL FLIGHTS,3,3,6
14,APR,2017,LOCAL FLIGHTS,1,1,2
15,APR,2017,LOCAL FLIGHTS,0,0,0
16,APR,2017,LOCAL FLIGHTS,0,0,0
17,APR,2017,LOCAL FLIGHTS,0,0,0
18,APR,2017,LOCAL FLIGHTS,3,3,6
19,APR,2017,LOCAL FLIGHTS,0,0,0
20,APR,2017,LOCAL FLIGHTS,5,5,10
21,APR,2017,LOCAL FLIGHTS,2,2,4
22,APR,2017,LOCAL FLIGHTS,4,4,8
23,APR,2017,LOCAL FLIGHTS,0,0,0
24,APR,2017,LOCAL FLIGHTS,1,1,2
25,APR,2017,LOCAL FLIGHTS,5,5,10
26,APR,2017,LOCAL FLIGHTS,1,1,2
27,APR,2017,LOCAL FLIGHTS,3,3,6
28,APR,2017,LOCAL FLIGHTS,5,5,10
29,APR,2017,LOCAL FLIGHTS,1,1,2
30,APR,2017,LOCAL FLIGHTS,1,1,2
1,APR,2017,HELICOPTER FLIGHTS,0,0,0
2,APR,2017,HELICOPTER FLIGHTS,0,0,0
3,APR,2017,HELICOPTER FLIGHTS,2,2,4
4,APR,2017,HELICOPTER FLIGHTS,7,7,14
5,APR,2017,HELICOPTER FLIGHTS,4,4,8
6,APR,2017,HELICOPTER FLIGHTS,9,9,18
7,APR,2017,HELICOPTER FLIGHTS,0,0,0
8,APR,2017,HELICOPTER FLIGHTS,0,0,0
9,APR,2017,HELICOPTER FLIGHTS,0,0,0
10,APR,2017,HELICOPTER FLIGHTS,4,4,8
11,APR,2017,HELICOPTER FLIGHTS,7,7,14
12,APR,2017,HELICOPTER FLIGHTS,3,2,5
13,APR,2017,HELICOPTER FLIGHTS,2,2,4
14,APR,2017,HELICOPTER FLIGHTS,0,0,0
15,APR,2017,HELICOPTER FLIGHTS,0,0,0
16,APR,2017,HELICOPTER FLIGHTS,0,0,0
17,APR,2017,HELICOPTER FLIGHTS,0,0,0
18,APR,2017,HELICOPTER FLIGHTS,0,0,0
19,APR,2017,HELICOPTER FLIGHTS,0,0,0
20,APR,2017,HELICOPTER FLIGHTS,12,12,24
21,APR,2017,HELICOPTER FLIGHTS,6,6,12
22,APR,2017,HELICOPTER FLIGHTS,2,2,4
23,APR,2017,HELICOPTER FLIGHTS,0,0,0
24,APR,2017,HELICOPTER FLIGHTS,2,2,4
25,APR,2017,HELICOPTER FLIGHTS,4,4,8
26,APR,2017,HELICOPTER FLIGHTS,6,6,12
27,APR,2017,HELICOPTER FLIGHTS,13,13,26
28,APR,2017,HELICOPTER FLIGHTS,2,2,4
29,APR,2017,HELICOPTER FLIGHTS,0,0,0
30,APR,2017,HELICOPTER FLIGHTS,0,0,0
1,MAY,2017,INTERNATIONAL FLIGHTS,21,20,41
2,MAY,2017,INTERNATIONAL FLIGHTS,19,24,43
3,MAY,2017,INTERNATIONAL FLIGHTS,49,48,97
4,MAY,2017,INTERNATIONAL FLIGHTS,23,24,47
5,MAY,2017,INTERNATIONAL FLIGHTS,20,17,37
6,MAY,2017,INTERNATIONAL FLIGHTS,37,39,76
7,MAY,2017,INTERNATIONAL FLIGHTS,35,37,72
8,MAY,2017,INTERNATIONAL FLIGHTS,18,19,37
9,MAY,2017,INTERNATIONAL FLIGHTS,21,20,41
10,MAY,2017,INTERNATIONAL FLIGHTS,50,49,99
11,MAY,2017,INTERNATIONAL FLIGHTS,22,25,47
12,MAY,2017,INTERNATIONAL FLIGHTS,16,15,31
13,MAY,2017,INTERNATIONAL FLIGHTS,34,33,67
14,MAY,2017,INTERNATIONAL FLIGHTS,35,33,68
15,MAY,2017,INTERNATIONAL FLIGHTS,17,19,36
16,MAY,2017,INTERNATIONAL FLIGHTS,23,24,47
17,MAY,2017,INTERNATIONAL FLIGHTS,48,48,96
18,MAY,2017,INTERNATIONAL FLIGHTS,28,26,54
19,MAY,2017,INTERNATIONAL FLIGHTS,14,15,29
20,MAY,2017,INTERNATIONAL FLIGHTS,35,36,71
21,MAY,2017,INTERNATIONAL FLIGHTS,36,36,72
22,MAY,2017,INTERNATIONAL FLIGHTS,18,18,36
23,MAY,2017,INTERNATIONAL FLIGHTS,21,20,41
24,MAY,2017,INTERNATIONAL FLIGHTS,51,52,103
25,MAY,2017,INTERNATIONAL FLIGHTS,23,22,45
26,MAY,2017,INTERNATIONAL FLIGHTS,17,18,35
27,MAY,2017,INTERNATIONAL FLIGHTS,39,35,74
28,MAY,2017,INTERNATIONAL FLIGHTS,35,40,75
29,MAY,2017,INTERNATIONAL FLIGHTS,27,22,49
30,MAY,2017,INTERNATIONAL FLIGHTS,23,22,45
31,MAY,2017,INTERNATIONAL FLIGHTS,51,53,104
1,MAY,2017,LOCAL FLIGHTS,0,0,0
2,MAY,2017,LOCAL FLIGHTS,3,3,6
3,MAY,2017,LOCAL FLIGHTS,2,2,4
4,MAY,2017,LOCAL FLIGHTS,3,3,6
5,MAY,2017,LOCAL FLIGHTS,3,3,6
6,MAY,2017,LOCAL FLIGHTS,2,2,4
7,MAY,2017,LOCAL FLIGHTS,0,0,0
8,MAY,2017,LOCAL FLIGHTS,5,5,10
9,MAY,2017,LOCAL FLIGHTS,1,1,2
10,MAY,2017,LOCAL FLIGHTS,0,0,0
11,MAY,2017,LOCAL FLIGHTS,2,2,4
12,MAY,2017,LOCAL FLIGHTS,1,1,2
13,MAY,2017,LOCAL FLIGHTS,1,1,2
14,MAY,2017,LOCAL FLIGHTS,0,0,0
15,MAY,2017,LOCAL FLIGHTS,5,6,11
16,MAY,2017,LOCAL FLIGHTS,4,4,8
17,MAY,2017,LOCAL FLIGHTS,2,3,5
18,MAY,2017,LOCAL FLIGHTS,7,7,14
19,MAY,2017,LOCAL FLIGHTS,0,0,0
20,MAY,2017,LOCAL FLIGHTS,1,2,3
21,MAY,2017,LOCAL FLIGHTS,1,1,2
22,MAY,2017,LOCAL FLIGHTS,1,1,2
23,MAY,2017,LOCAL FLIGHTS,0,0,0
24,MAY,2017,LOCAL FLIGHTS,1,1,2
25,MAY,2017,LOCAL FLIGHTS,4,4,8
26,MAY,2017,LOCAL FLIGHTS,4,4,8
27,MAY,2017,LOCAL FLIGHTS,3,2,5
28,MAY,2017,LOCAL FLIGHTS,0,0,0
29,MAY,2017,LOCAL FLIGHTS,2,2,4
30,MAY,2017,LOCAL FLIGHTS,3,3,6
31,MAY,2017,LOCAL FLIGHTS,0,0,0
1,MAY,2017,HELICOPTER FLIGHTS,0,0,0
2,MAY,2017,HELICOPTER FLIGHTS,11,11,22
3,MAY,2017,HELICOPTER FLIGHTS,13,13,26
4,MAY,2017,HELICOPTER FLIGHTS,18,18,36
5,MAY,2017,HELICOPTER FLIGHTS,1,1,2
6,MAY,2017,HELICOPTER FLIGHTS,0,0,0
7,MAY,2017,HELICOPTER FLIGHTS,0,0,0
8,MAY,2017,HELICOPTER FLIGHTS,8,8,16
9,MAY,2017,HELICOPTER FLIGHTS,8,8,16
10,MAY,2017,HELICOPTER FLIGHTS,5,5,10
11,MAY,2017,HELICOPTER FLIGHTS,8,8,16
12,MAY,2017,HELICOPTER FLIGHTS,3,3,6
13,MAY,2017,HELICOPTER FLIGHTS,2,2,4
14,MAY,2017,HELICOPTER FLIGHTS,0,0,0
15,MAY,2017,HELICOPTER FLIGHTS,4,4,8
16,MAY,2017,HELICOPTER FLIGHTS,7,7,14
17,MAY,2017,HELICOPTER FLIGHTS,3,3,6
18,MAY,2017,HELICOPTER FLIGHTS,9,9,18
19,MAY,2017,HELICOPTER FLIGHTS,0,0,0
20,MAY,2017,HELICOPTER FLIGHTS,0,0,0
21,MAY,2017,HELICOPTER FLIGHTS,0,0,0
22,MAY,2017,HELICOPTER FLIGHTS,7,7,14
23,MAY,2017,HELICOPTER FLIGHTS,9,9,18
24,MAY,2017,HELICOPTER FLIGHTS,7,7,14
25,MAY,2017,HELICOPTER FLIGHTS,12,12,24
26,MAY,2017,HELICOPTER FLIGHTS,0,0,0
27,MAY,2017,HELICOPTER FLIGHTS,1,1,2
28,MAY,2017,HELICOPTER FLIGHTS,1,1,2
29,MAY,2017,HELICOPTER FLIGHTS,8,8,16
30,MAY,2017,HELICOPTER FLIGHTS,12,12,24
31,MAY,2017,HELICOPTER FLIGHTS,7,7,14
1,JUN,2017,INTERNATIONAL FLIGHTS,29,28,57
2,JUN,2017,INTERNATIONAL FLIGHTS,21,21,42
3,JUN,2017,INTERNATIONAL FLIGHTS,38,40,78
4,JUN,2017,INTERNATIONAL FLIGHTS,37,38,75
5,JUN,2017,INTERNATIONAL FLIGHTS,21,18,39
6,JUN,2017,INTERNATIONAL FLIGHTS,25,26,51
7,JUN,2017,INTERNATIONAL FLIGHTS,64,55,119
8,JUN,2017,INTERNATIONAL FLIGHTS,25,36,61
9,JUN,2017,INTERNATIONAL FLIGHTS,18,19,37
10,JUN,2017,INTERNATIONAL FLIGHTS,38,34,72
11,JUN,2017,INTERNATIONAL FLIGHTS,55,49,104
12,JUN,2017,INTERNATIONAL FLIGHTS,26,22,48
13,JUN,2017,INTERNATIONAL FLIGHTS,24,26,50
14,JUN,2017,INTERNATIONAL FLIGHTS,58,65,123
15,JUN,2017,INTERNATIONAL FLIGHTS,33,36,69
16,JUN,2017,INTERNATIONAL FLIGHTS,24,20,44
17,JUN,2017,INTERNATIONAL FLIGHTS,36,37,73
18,JUN,2017,INTERNATIONAL FLIGHTS,40,40,80
19,JUN,2017,INTERNATIONAL FLIGHTS,27,28,55
20,JUN,2017,INTERNATIONAL FLIGHTS,22,22,44
21,JUN,2017,INTERNATIONAL FLIGHTS,49,51,100
22,JUN,2017,INTERNATIONAL FLIGHTS,26,23,49
23,JUN,2017,INTERNATIONAL FLIGHTS,20,21,41
24,JUN,2017,INTERNATIONAL FLIGHTS,37,39,76
25,JUN,2017,INTERNATIONAL FLIGHTS,41,43,84
26,JUN,2017,INTERNATIONAL FLIGHTS,23,22,45
27,JUN,2017,INTERNATIONAL FLIGHTS,21,20,41
28,JUN,2017,INTERNATIONAL FLIGHTS,55,51,106
29,JUN,2017,INTERNATIONAL FLIGHTS,33,35,68
30,JUN,2017,INTERNATIONAL FLIGHTS,23,24,47
1,JUN,2017,LOCAL FLIGHTS,3,3,6
2,JUN,2017,LOCAL FLIGHTS,1,1,2
3,JUN,2017,LOCAL FLIGHTS,2,2,4
4,JUN,2017,LOCAL FLIGHTS,0,0,0
5,JUN,2017,LOCAL FLIGHTS,0,0,0
6,JUN,2017,LOCAL FLIGHTS,3,3,6
7,JUN,2017,LOCAL FLIGHTS,0,0,0
8,JUN,2017,LOCAL FLIGHTS,0,0,0
9,JUN,2017,LOCAL FLIGHTS,2,2,4
10,JUN,2017,LOCAL FLIGHTS,1,1,2
11,JUN,2017,LOCAL FLIGHTS,0,0,0
12,JUN,2017,LOCAL FLIGHTS,2,2,4
13,JUN,2017,LOCAL FLIGHTS,1,1,2
14,JUN,2017,LOCAL FLIGHTS,0,0,0
15,JUN,2017,LOCAL FLIGHTS,2,1,3
16,JUN,2017,LOCAL FLIGHTS,2,2,4
17,JUN,2017,LOCAL FLIGHTS,0,0,0
18,JUN,2017,LOCAL FLIGHTS,0,0,0
19,JUN,2017,LOCAL FLIGHTS,4,5,9
20,JUN,2017,LOCAL FLIGHTS,3,3,6
21,JUN,2017,LOCAL FLIGHTS,3,3,6
22,JUN,2017,LOCAL FLIGHTS,2,2,4
23,JUN,2017,LOCAL FLIGHTS,2,2,4
24,JUN,2017,LOCAL FLIGHTS,5,5,10
25,JUN,2017,LOCAL FLIGHTS,0,0,0
26,JUN,2017,LOCAL FLIGHTS,1,1,2
27,JUN,2017,LOCAL FLIGHTS,3,3,6
28,JUN,2017,LOCAL FLIGHTS,4,4,8
29,JUN,2017,LOCAL FLIGHTS,4,4,8
30,JUN,2017,LOCAL FLIGHTS,1,1,2
1,JUN,2017,HELICOPTER FLIGHTS,9,9,18
2,JUN,2017,HELICOPTER FLIGHTS,0,0,0
3,JUN,2017,HELICOPTER FLIGHTS,0,0,0
4,JUN,2017,HELICOPTER FLIGHTS,1,1,2
5,JUN,2017,HELICOPTER FLIGHTS,0,0,0
6,JUN,2017,HELICOPTER FLIGHTS,7,7,14
7,JUN,2017,HELICOPTER FLIGHTS,23,23,46
8,JUN,2017,HELICOPTER FLIGHTS,35,35,70
9,JUN,2017,HELICOPTER FLIGHTS,2,2,4
10,JUN,2017,HELICOPTER FLIGHTS,0,0,0
11,JUN,2017,HELICOPTER FLIGHTS,24,24,48
12,JUN,2017,HELICOPTER FLIGHTS,39,39,78
13,JUN,2017,HELICOPTER FLIGHTS,22,22,44
14,JUN,2017,HELICOPTER FLIGHTS,32,32,64
15,JUN,2017,HELICOPTER FLIGHTS,9,9,18
16,JUN,2017,HELICOPTER FLIGHTS,1,1,2
17,JUN,2017,HELICOPTER FLIGHTS,0,0,0
18,JUN,2017,HELICOPTER FLIGHTS,0,0,0
19,JUN,2017,HELICOPTER FLIGHTS,12,12,24
20,JUN,2017,HELICOPTER FLIGHTS,7,7,14
21,JUN,2017,HELICOPTER FLIGHTS,5,5,10
22,JUN,2017,HELICOPTER FLIGHTS,8,8,16
23,JUN,2017,HELICOPTER FLIGHTS,3,3,6
24,JUN,2017,HELICOPTER FLIGHTS,15,15,30
25,JUN,2017,HELICOPTER FLIGHTS,8,8,16
26,JUN,2017,HELICOPTER FLIGHTS,5,5,10
27,JUN,2017,HELICOPTER FLIGHTS,9,9,18
28,JUN,2017,HELICOPTER FLIGHTS,12,12,24
29,JUN,2017,HELICOPTER FLIGHTS,10,10,20
30,JUN,2017,HELICOPTER FLIGHTS,0,0,0
1,JUL,2017,INTERNATIONAL FLIGHTS,32,34,66
2,JUL,2017,INTERNATIONAL FLIGHTS,40,38,78
3,JUL,2017,INTERNATIONAL FLIGHTS,24,25,49
4,JUL,2017,INTERNATIONAL FLIGHTS,26,22,48
5,JUL,2017,INTERNATIONAL FLIGHTS,56,58,114
6,JUL,2017,INTERNATIONAL FLIGHTS,32,32,64
7,JUL,2017,INTERNATIONAL FLIGHTS,18,21,39
8,JUL,2017,INTERNATIONAL FLIGHTS,39,39,78
9,JUL,2017,INTERNATIONAL FLIGHTS,38,38,76
10,JUL,2017,INTERNATIONAL FLIGHTS,25,22,47
11,JUL,2017,INTERNATIONAL FLIGHTS,24,25,49
12,JUL,2017,INTERNATIONAL FLIGHTS,52,51,103
13,JUL,2017,INTERNATIONAL FLIGHTS,30,31,61
14,JUL,2017,INTERNATIONAL FLIGHTS,19,21,40
15,JUL,2017,INTERNATIONAL FLIGHTS,35,37,72
16,JUL,2017,INTERNATIONAL FLIGHTS,38,38,76
17,JUL,2017,INTERNATIONAL FLIGHTS,24,24,48
18,JUL,2017,INTERNATIONAL FLIGHTS,21,20,41
19,JUL,2017,INTERNATIONAL FLIGHTS,53,52,105
20,JUL,2017,INTERNATIONAL FLIGHTS,36,33,69
21,JUL,2017,INTERNATIONAL FLIGHTS,21,21,42
22,JUL,2017,INTERNATIONAL FLIGHTS,32,38,70
23,JUL,2017,INTERNATIONAL FLIGHTS,41,39,80
24,JUL,2017,INTERNATIONAL FLIGHTS,24,23,47
25,JUL,2017,INTERNATIONAL FLIGHTS,21,23,44
26,JUL,2017,INTERNATIONAL FLIGHTS,52,52,104
27,JUL,2017,INTERNATIONAL FLIGHTS,39,34,73
28,JUL,2017,INTERNATIONAL FLIGHTS,21,23,44
29,JUL,2017,INTERNATIONAL FLIGHTS,35,36,71
30,JUL,2017,INTERNATIONAL FLIGHTS,40,40,80
31,JUL,2017,INTERNATIONAL FLIGHTS,26,25,51
1,JUL,2017,LOCAL FLIGHTS,3,3,6
2,JUL,2017,LOCAL FLIGHTS,0,0,0
3,JUL,2017,LOCAL FLIGHTS,4,4,8
4,JUL,2017,LOCAL FLIGHTS,2,2,4
5,JUL,2017,LOCAL FLIGHTS,4,4,8
6,JUL,2017,LOCAL FLIGHTS,3,3,6
7,JUL,2017,LOCAL FLIGHTS,5,4,9
8,JUL,2017,LOCAL FLIGHTS,5,5,10
9,JUL,2017,LOCAL FLIGHTS,2,2,4
10,JUL,2017,LOCAL FLIGHTS,3,3,6
11,JUL,2017,LOCAL FLIGHTS,6,6,12
12,JUL,2017,LOCAL FLIGHTS,20,20,40
13,JUL,2017,LOCAL FLIGHTS,2,2,4
14,JUL,2017,LOCAL FLIGHTS,3,3,6
15,JUL,2017,LOCAL FLIGHTS,3,3,6
16,JUL,2017,LOCAL FLIGHTS,0,0,0
17,JUL,2017,LOCAL FLIGHTS,0,0,0
18,JUL,2017,LOCAL FLIGHTS,4,4,8
19,JUL,2017,LOCAL FLIGHTS,0,1,1
20,JUL,2017,LOCAL FLIGHTS,5,5,10
21,JUL,2017,LOCAL FLIGHTS,2,2,4
22,JUL,2017,LOCAL FLIGHTS,2,2,4
23,JUL,2017,LOCAL FLIGHTS,0,0,0
24,JUL,2017,LOCAL FLIGHTS,0,0,0
25,JUL,2017,LOCAL FLIGHTS,3,3,6
26,JUL,2017,LOCAL FLIGHTS,0,0,0
27,JUL,2017,LOCAL FLIGHTS,14,14,28
28,JUL,2017,LOCAL FLIGHTS,1,1,2
29,JUL,2017,LOCAL FLIGHTS,15,15,30
30,JUL,2017,LOCAL FLIGHTS,0,0,0
31,JUL,2017,LOCAL FLIGHTS,2,2,4
1,JUL,2017,HELICOPTER FLIGHTS,0,0,0
2,JUL,2017,HELICOPTER FLIGHTS,2,2,4
3,JUL,2017,HELICOPTER FLIGHTS,2,2,4
4,JUL,2017,HELICOPTER FLIGHTS,5,5,10
5,JUL,2017,HELICOPTER FLIGHTS,5,5,10
6,JUL,2017,HELICOPTER FLIGHTS,11,11,22
7,JUL,2017,HELICOPTER FLIGHTS,0,0,0
8,JUL,2017,HELICOPTER FLIGHTS,0,0,0
9,JUL,2017,HELICOPTER FLIGHTS,2,2,4
10,JUL,2017,HELICOPTER FLIGHTS,4,4,8
11,JUL,2017,HELICOPTER FLIGHTS,6,6,12
12,JUL,2017,HELICOPTER FLIGHTS,14,14,28
13,JUL,2017,HELICOPTER FLIGHTS,4,4,8
14,JUL,2017,HELICOPTER FLIGHTS,0,0,0
15,JUL,2017,HELICOPTER FLIGHTS,0,0,0
16,JUL,2017,HELICOPTER FLIGHTS,1,1,2
17,JUL,2017,HELICOPTER FLIGHTS,9,9,18
18,JUL,2017,HELICOPTER FLIGHTS,6,6,12
19,JUL,2017,HELICOPTER FLIGHTS,7,7,14
20,JUL,2017,HELICOPTER FLIGHTS,9,9,18
21,JUL,2017,HELICOPTER FLIGHTS,1,1,2
22,JUL,2017,HELICOPTER FLIGHTS,0,0,0
23,JUL,2017,HELICOPTER FLIGHTS,0,0,0
24,JUL,2017,HELICOPTER FLIGHTS,3,3,6
25,JUL,2017,HELICOPTER FLIGHTS,6,6,12
26,JUL,2017,HELICOPTER FLIGHTS,7,7,14
27,JUL,2017,HELICOPTER FLIGHTS,13,13,26
28,JUL,2017,HELICOPTER FLIGHTS,2,2,4
29,JUL,2017,HELICOPTER FLIGHTS,6,6,12
30,JUL,2017,HELICOPTER FLIGHTS,0,0,0
31,JUL,2017,HELICOPTER FLIGHTS,7,7,14
1,AUG,2017,INTERNATIONAL FLIGHTS,21,20,41
2,AUG,2017,INTERNATIONAL FLIGHTS,51,53,104
3,AUG,2017,INTERNATIONAL FLIGHTS,28,26,54
4,AUG,2017,INTERNATIONAL FLIGHTS,18,21,39
5,AUG,2017,INTERNATIONAL FLIGHTS,37,36,73
6,AUG,2017,INTERNATIONAL FLIGHTS,40,41,81
7,AUG,2017,INTERNATIONAL FLIGHTS,23,23,46
8,AUG,2017,INTERNATIONAL FLIGHTS,25,23,48
9,AUG,2017,INTERNATIONAL FLIGHTS,49,49,98
10,AUG,2017,INTERNATIONAL FLIGHTS,35,32,67
11,AUG,2017,INTERNATIONAL FLIGHTS,21,24,45
12,AUG,2017,INTERNATIONAL FLIGHTS,37,37,74
13,AUG,2017,INTERNATIONAL FLIGHTS,39,42,81
14,AUG,2017,INTERNATIONAL FLIGHTS,30,25,55
15,AUG,2017,INTERNATIONAL FLIGHTS,29,32,61
16,AUG,2017,INTERNATIONAL FLIGHTS,50,51,101
17,AUG,2017,INTERNATIONAL FLIGHTS,28,29,57
18,AUG,2017,INTERNATIONAL FLIGHTS,20,21,41
19,AUG,2017,INTERNATIONAL FLIGHTS,36,35,71
20,AUG,2017,INTERNATIONAL FLIGHTS,42,41,83
21,AUG,2017,INTERNATIONAL FLIGHTS,27,27,54
22,AUG,2017,INTERNATIONAL FLIGHTS,20,21,41
23,AUG,2017,INTERNATIONAL FLIGHTS,52,49,101
24,AUG,2017,INTERNATIONAL FLIGHTS,29,32,61
25,AUG,2017,INTERNATIONAL FLIGHTS,18,19,37
26,AUG,2017,INTERNATIONAL FLIGHTS,39,38,77
27,AUG,2017,INTERNATIONAL FLIGHTS,37,37,74
28,AUG,2017,INTERNATIONAL FLIGHTS,26,25,51
29,AUG,2017,INTERNATIONAL FLIGHTS,23,20,43
30,AUG,2017,INTERNATIONAL FLIGHTS,50,52,102
31,AUG,2017,INTERNATIONAL FLIGHTS,31,30,61
1,AUG,2017,LOCAL FLIGHTS,1,1,2
2,AUG,2017,LOCAL FLIGHTS,1,1,2
3,AUG,2017,LOCAL FLIGHTS,2,2,4
4,AUG,2017,LOCAL FLIGHTS,0,1,1
5,AUG,2017,LOCAL FLIGHTS,1,1,2
6,AUG,2017,LOCAL FLIGHTS,0,0,0
7,AUG,2017,LOCAL FLIGHTS,0,0,0
8,AUG,2017,LOCAL FLIGHTS,1,1,2
9,AUG,2017,LOCAL FLIGHTS,0,0,0
10,AUG,2017,LOCAL FLIGHTS,5,5,10
11,AUG,2017,LOCAL FLIGHTS,2,2,4
12,AUG,2017,LOCAL FLIGHTS,3,3,6
13,AUG,2017,LOCAL FLIGHTS,0,0,0
14,AUG,2017,LOCAL FLIGHTS,1,1,2
15,AUG,2017,LOCAL FLIGHTS,0,0,0
16,AUG,2017,LOCAL FLIGHTS,1,1,2
17,AUG,2017,LOCAL FLIGHTS,1,1,2
18,AUG,2017,LOCAL FLIGHTS,3,3,6
19,AUG,2017,LOCAL FLIGHTS,2,3,5
20,AUG,2017,LOCAL FLIGHTS,0,0,0
21,AUG,2017,LOCAL FLIGHTS,2,2,4
22,AUG,2017,LOCAL FLIGHTS,1,1,2
23,AUG,2017,LOCAL FLIGHTS,2,1,3
24,AUG,2017,LOCAL FLIGHTS,1,1,2
25,AUG,2017,LOCAL FLIGHTS,1,1,2
26,AUG,2017,LOCAL FLIGHTS,1,1,2
27,AUG,2017,LOCAL FLIGHTS,2,2,4
28,AUG,2017,LOCAL FLIGHTS,1,1,2
29,AUG,2017,LOCAL FLIGHTS,2,2,4
30,AUG,2017,LOCAL FLIGHTS,0,0,0
31,AUG,2017,LOCAL FLIGHTS,1,1,2
1,AUG,2017,HELICOPTER FLIGHTS,8,8,16
2,AUG,2017,HELICOPTER FLIGHTS,6,6,12
3,AUG,2017,HELICOPTER FLIGHTS,14,14,28
4,AUG,2017,HELICOPTER FLIGHTS,1,1,2
5,AUG,2017,HELICOPTER FLIGHTS,0,0,0
6,AUG,2017,HELICOPTER FLIGHTS,0,0,0
7,AUG,2017,HELICOPTER FLIGHTS,5,5,10
8,AUG,2017,HELICOPTER FLIGHTS,2,2,4
9,AUG,2017,HELICOPTER FLIGHTS,6,6,12
10,AUG,2017,HELICOPTER FLIGHTS,5,5,10
11,AUG,2017,HELICOPTER FLIGHTS,0,0,0
12,AUG,2017,HELICOPTER FLIGHTS,0,0,0
13,AUG,2017,HELICOPTER FLIGHTS,0,0,0
14,AUG,2017,HELICOPTER FLIGHTS,1,1,2
15,AUG,2017,HELICOPTER FLIGHTS,0,0,0
16,AUG,2017,HELICOPTER FLIGHTS,6,6,12
17,AUG,2017,HELICOPTER FLIGHTS,10,10,20
18,AUG,2017,HELICOPTER FLIGHTS,0,0,0
19,AUG,2017,HELICOPTER FLIGHTS,0,0,0
20,AUG,2017,HELICOPTER FLIGHTS,0,0,0
21,AUG,2017,HELICOPTER FLIGHTS,3,3,6
22,AUG,2017,HELICOPTER FLIGHTS,7,7,14
23,AUG,2017,HELICOPTER FLIGHTS,8,8,16
24,AUG,2017,HELICOPTER FLIGHTS,10,10,20
25,AUG,2017,HELICOPTER FLIGHTS,0,0,0
26,AUG,2017,HELICOPTER FLIGHTS,0,0,0
27,AUG,2017,HELICOPTER FLIGHTS,2,2,4
28,AUG,2017,HELICOPTER FLIGHTS,8,8,16
29,AUG,2017,HELICOPTER FLIGHTS,6,6,12
30,AUG,2017,HELICOPTER FLIGHTS,6,6,12
31,AUG,2017,HELICOPTER FLIGHTS,16,16,32
1,SEP,2017,INTERNATIONAL FLIGHTS,21,19,40
2,SEP,2017,INTERNATIONAL FLIGHTS,38,36,74
3,SEP,2017,INTERNATIONAL FLIGHTS,51,55,106
4,SEP,2017,INTERNATIONAL FLIGHTS,25,25,50
5,SEP,2017,INTERNATIONAL FLIGHTS,27,30,57
6,SEP,2017,INTERNATIONAL FLIGHTS,52,49,101
7,SEP,2017,INTERNATIONAL FLIGHTS,29,34,63
8,SEP,2017,INTERNATIONAL FLIGHTS,24,20,44
9,SEP,2017,INTERNATIONAL FLIGHTS,34,38,72
10,SEP,2017,INTERNATIONAL FLIGHTS,39,39,78
11,SEP,2017,INTERNATIONAL FLIGHTS,21,20,41
12,SEP,2017,INTERNATIONAL FLIGHTS,21,19,40
13,SEP,2017,INTERNATIONAL FLIGHTS,49,51,100
14,SEP,2017,INTERNATIONAL FLIGHTS,26,26,52
15,SEP,2017,INTERNATIONAL FLIGHTS,22,22,44
16,SEP,2017,INTERNATIONAL FLIGHTS,33,35,68
17,SEP,2017,INTERNATIONAL FLIGHTS,40,40,80
18,SEP,2017,INTERNATIONAL FLIGHTS,24,22,46
19,SEP,2017,INTERNATIONAL FLIGHTS,22,25,47
20,SEP,2017,INTERNATIONAL FLIGHTS,53,49,102
21,SEP,2017,INTERNATIONAL FLIGHTS,26,28,54
22,SEP,2017,INTERNATIONAL FLIGHTS,19,18,37
23,SEP,2017,INTERNATIONAL FLIGHTS,36,36,72
24,SEP,2017,INTERNATIONAL FLIGHTS,40,40,80
25,SEP,2017,INTERNATIONAL FLIGHTS,24,22,46
26,SEP,2017,INTERNATIONAL FLIGHTS,35,22,57
27,SEP,2017,INTERNATIONAL FLIGHTS,48,61,109
28,SEP,2017,INTERNATIONAL FLIGHTS,24,26,50
29,SEP,2017,INTERNATIONAL FLIGHTS,17,16,33
30,SEP,2017,INTERNATIONAL FLIGHTS,38,36,74
1,SEP,2017,LOCAL FLIGHTS,2,2,4
2,SEP,2017,LOCAL FLIGHTS,4,4,8
3,SEP,2017,LOCAL FLIGHTS,0,0,0
4,SEP,2017,LOCAL FLIGHTS,3,3,6
5,SEP,2017,LOCAL FLIGHTS,8,7,15
6,SEP,2017,LOCAL FLIGHTS,8,7,15
7,SEP,2017,LOCAL FLIGHTS,3,3,6
8,SEP,2017,LOCAL FLIGHTS,4,4,8
9,SEP,2017,LOCAL FLIGHTS,4,4,8
10,SEP,2017,LOCAL FLIGHTS,20,20,40
11,SEP,2017,LOCAL FLIGHTS,0,0,0
12,SEP,2017,LOCAL FLIGHTS,2,2,4
13,SEP,2017,LOCAL FLIGHTS,1,1,2
14,SEP,2017,LOCAL FLIGHTS,1,1,2
15,SEP,2017,LOCAL FLIGHTS,1,1,2
16,SEP,2017,LOCAL FLIGHTS,5,6,11
17,SEP,2017,LOCAL FLIGHTS,0,0,0
18,SEP,2017,LOCAL FLIGHTS,0,0,0
19,SEP,2017,LOCAL FLIGHTS,1,1,2
20,SEP,2017,LOCAL FLIGHTS,1,1,2
21,SEP,2017,LOCAL FLIGHTS,0,0,0
22,SEP,2017,LOCAL FLIGHTS,3,3,6
23,SEP,2017,LOCAL FLIGHTS,2,2,4
24,SEP,2017,LOCAL FLIGHTS,0,0,0
25,SEP,2017,LOCAL FLIGHTS,0,0,0
26,SEP,2017,LOCAL FLIGHTS,1,1,2
27,SEP,2017,LOCAL FLIGHTS,1,1,2
28,SEP,2017,LOCAL FLIGHTS,1,1,2
29,SEP,2017,LOCAL FLIGHTS,3,3,6
30,SEP,2017,LOCAL FLIGHTS,0,0,0
1,SEP,2017,HELICOPTER FLIGHTS,1,1,2
2,SEP,2017,HELICOPTER FLIGHTS,2,2,4
3,SEP,2017,HELICOPTER FLIGHTS,0,0,0
4,SEP,2017,HELICOPTER FLIGHTS,5,5,10
5,SEP,2017,HELICOPTER FLIGHTS,1,1,2
6,SEP,2017,HELICOPTER FLIGHTS,1,1,2
7,SEP,2017,HELICOPTER FLIGHTS,6,6,12
8,SEP,2017,HELICOPTER FLIGHTS,0,0,0
9,SEP,2017,HELICOPTER FLIGHTS,1,1,2
10,SEP,2017,HELICOPTER FLIGHTS,9,9,18
11,SEP,2017,HELICOPTER FLIGHTS,10,10,20
12,SEP,2017,HELICOPTER FLIGHTS,12,12,24
13,SEP,2017,HELICOPTER FLIGHTS,2,2,4
14,SEP,2017,HELICOPTER FLIGHTS,7,7,14
15,SEP,2017,HELICOPTER FLIGHTS,3,3,6
16,SEP,2017,HELICOPTER FLIGHTS,0,0,0
17,SEP,2017,HELICOPTER FLIGHTS,0,0,0
18,SEP,2017,HELICOPTER FLIGHTS,4,4,8
19,SEP,2017,HELICOPTER FLIGHTS,9,9,18
20,SEP,2017,HELICOPTER FLIGHTS,4,4,8
21,SEP,2017,HELICOPTER FLIGHTS,15,15,30
22,SEP,2017,HELICOPTER FLIGHTS,2,2,4
23,SEP,2017,HELICOPTER FLIGHTS,0,0,0
24,SEP,2017,HELICOPTER FLIGHTS,1,1,2
25,SEP,2017,HELICOPTER FLIGHTS,8,8,16
26,SEP,2017,HELICOPTER FLIGHTS,12,12,24
27,SEP,2017,HELICOPTER FLIGHTS,12,12,24
28,SEP,2017,HELICOPTER FLIGHTS,0,0,0
29,SEP,2017,HELICOPTER FLIGHTS,6,6,12
30,SEP,2017,HELICOPTER FLIGHTS,10,10,20
1,OCT,2017,INTERNATIONAL FLIGHTS,41,41,82
2,OCT,2017,INTERNATIONAL FLIGHTS,26,20,46
3,OCT,2017,INTERNATIONAL FLIGHTS,23,26,49
4,OCT,2017,INTERNATIONAL FLIGHTS,56,54,110
5,OCT,2017,INTERNATIONAL FLIGHTS,31,29,60
6,OCT,2017,INTERNATIONAL FLIGHTS,21,26,47
7,OCT,2017,INTERNATIONAL FLIGHTS,38,36,74
8,OCT,2017,INTERNATIONAL FLIGHTS,40,40,80
9,OCT,2017,INTERNATIONAL FLIGHTS,19,21,40
10,OCT,2017,INTERNATIONAL FLIGHTS,24,22,46
11,OCT,2017,INTERNATIONAL FLIGHTS,50,52,102
12,OCT,2017,INTERNATIONAL FLIGHTS,25,27,52
13,OCT,2017,INTERNATIONAL FLIGHTS,20,18,38
14,OCT,2017,INTERNATIONAL FLIGHTS,33,33,66
15,OCT,2017,INTERNATIONAL FLIGHTS,41,40,81
16,OCT,2017,INTERNATIONAL FLIGHTS,24,25,49
17,OCT,2017,INTERNATIONAL FLIGHTS,20,22,42
18,OCT,2017,INTERNATIONAL FLIGHTS,48,48,96
19,OCT,2017,INTERNATIONAL FLIGHTS,25,23,48
20,OCT,2017,INTERNATIONAL FLIGHTS,23,22,45
21,OCT,2017,INTERNATIONAL FLIGHTS,43,42,85
22,OCT,2017,INTERNATIONAL FLIGHTS,41,44,85
23,OCT,2017,INTERNATIONAL FLIGHTS,20,18,38
24,OCT,2017,INTERNATIONAL FLIGHTS,19,22,41
25,OCT,2017,INTERNATIONAL FLIGHTS,49,49,98
26,OCT,2017,INTERNATIONAL FLIGHTS,26,25,51
27,OCT,2017,INTERNATIONAL FLIGHTS,21,22,43
28,OCT,2017,INTERNATIONAL FLIGHTS,44,42,86
29,OCT,2017,INTERNATIONAL FLIGHTS,33,38,71
30,OCT,2017,INTERNATIONAL FLIGHTS,24,17,41
31,OCT,2017,INTERNATIONAL FLIGHTS,21,22,43
1,OCT,2017,LOCAL FLIGHTS,0,0,0
2,OCT,2017,LOCAL FLIGHTS,1,1,2
3,OCT,2017,LOCAL FLIGHTS,2,2,4
4,OCT,2017,LOCAL FLIGHTS,2,3,5
5,OCT,2017,LOCAL FLIGHTS,3,3,6
6,OCT,2017,LOCAL FLIGHTS,3,3,6
7,OCT,2017,LOCAL FLIGHTS,4,4,8
8,OCT,2017,LOCAL FLIGHTS,0,0,0
9,OCT,2017,LOCAL FLIGHTS,2,2,4
10,OCT,2017,LOCAL FLIGHTS,2,2,4
11,OCT,2017,LOCAL FLIGHTS,2,2,4
12,OCT,2017,LOCAL FLIGHTS,3,2,5
13,OCT,2017,LOCAL FLIGHTS,2,2,4
14,OCT,2017,LOCAL FLIGHTS,3,3,6
15,OCT,2017,LOCAL FLIGHTS,0,0,0
16,OCT,2017,LOCAL FLIGHTS,2,2,4
17,OCT,2017,LOCAL FLIGHTS,3,3,6
18,OCT,2017,LOCAL FLIGHTS,1,1,2
19,OCT,2017,LOCAL FLIGHTS,1,1,2
20,OCT,2017,LOCAL FLIGHTS,3,3,6
21,OCT,2017,LOCAL FLIGHTS,4,4,8
22,OCT,2017,LOCAL FLIGHTS,1,1,2
23,OCT,2017,LOCAL FLIGHTS,0,1,1
24,OCT,2017,LOCAL FLIGHTS,3,3,6
25,OCT,2017,LOCAL FLIGHTS,1,1,2
26,OCT,2017,LOCAL FLIGHTS,0,0,0
27,OCT,2017,LOCAL FLIGHTS,1,1,2
28,OCT,2017,LOCAL FLIGHTS,2,1,3
29,OCT,2017,LOCAL FLIGHTS,0,0,0
30,OCT,2017,LOCAL FLIGHTS,0,0,0
31,OCT,2017,LOCAL FLIGHTS,3,3,6
1,OCT,2017,HELICOPTER FLIGHTS,10,10,20
2,OCT,2017,HELICOPTER FLIGHTS,2,2,4
3,OCT,2017,HELICOPTER FLIGHTS,7,7,14
4,OCT,2017,HELICOPTER FLIGHTS,8,8,16
5,OCT,2017,HELICOPTER FLIGHTS,6,6,12
6,OCT,2017,HELICOPTER FLIGHTS,2,2,4
7,OCT,2017,HELICOPTER FLIGHTS,0,0,0
8,OCT,2017,HELICOPTER FLIGHTS,0,0,0
9,OCT,2017,HELICOPTER FLIGHTS,5,5,10
10,OCT,2017,HELICOPTER FLIGHTS,11,11,22
11,OCT,2017,HELICOPTER FLIGHTS,9,9,18
12,OCT,2017,HELICOPTER FLIGHTS,13,13,26
13,OCT,2017,HELICOPTER FLIGHTS,1,1,2
14,OCT,2017,HELICOPTER FLIGHTS,0,0,0
15,OCT,2017,HELICOPTER FLIGHTS,0,0,0
16,OCT,2017,HELICOPTER FLIGHTS,8,8,16
17,OCT,2017,HELICOPTER FLIGHTS,7,7,14
18,OCT,2017,HELICOPTER FLIGHTS,10,10,20
19,OCT,2017,HELICOPTER FLIGHTS,15,15,30
20,OCT,2017,HELICOPTER FLIGHTS,3,3,6
21,OCT,2017,HELICOPTER FLIGHTS,4,4,8
22,OCT,2017,HELICOPTER FLIGHTS,1,1,2
23,OCT,2017,HELICOPTER FLIGHTS,9,9,18
24,OCT,2017,HELICOPTER FLIGHTS,10,10,20
25,OCT,2017,HELICOPTER FLIGHTS,6,6,12
26,OCT,2017,HELICOPTER FLIGHTS,4,4,8
27,OCT,2017,HELICOPTER FLIGHTS,0,0,0
28,OCT,2017,HELICOPTER FLIGHTS,3,3,6
29,OCT,2017,HELICOPTER FLIGHTS,0,0,0
30,OCT,2017,HELICOPTER FLIGHTS,4,4,8
31,OCT,2017,HELICOPTER FLIGHTS,7,7,14
1,NOV,2017,INTERNATIONAL FLIGHTS,45,45,90
2,NOV,2017,INTERNATIONAL FLIGHTS,19,22,41
3,NOV,2017,INTERNATIONAL FLIGHTS,11,10,21
4,NOV,2017,INTERNATIONAL FLIGHTS,23,24,47
5,NOV,2017,INTERNATIONAL FLIGHTS,27,28,55
6,NOV,2017,INTERNATIONAL FLIGHTS,13,11,24
7,NOV,2017,INTERNATIONAL FLIGHTS,16,18,34
8,NOV,2017,INTERNATIONAL FLIGHTS,41,40,81
9,NOV,2017,INTERNATIONAL FLIGHTS,17,17,34
10,NOV,2017,INTERNATIONAL FLIGHTS,10,8,18
11,NOV,2017,INTERNATIONAL FLIGHTS,22,21,43
12,NOV,2017,INTERNATIONAL FLIGHTS,24,27,51
13,NOV,2017,INTERNATIONAL FLIGHTS,12,11,23
14,NOV,2017,INTERNATIONAL FLIGHTS,13,10,23
15,NOV,2017,INTERNATIONAL FLIGHTS,39,41,80
16,NOV,2017,INTERNATIONAL FLIGHTS,15,16,31
17,NOV,2017,INTERNATIONAL FLIGHTS,7,6,13
18,NOV,2017,INTERNATIONAL FLIGHTS,26,25,51
19,NOV,2017,INTERNATIONAL FLIGHTS,25,28,53
20,NOV,2017,INTERNATIONAL FLIGHTS,8,8,16
21,NOV,2017,INTERNATIONAL FLIGHTS,12,11,23
22,NOV,2017,INTERNATIONAL FLIGHTS,35,36,71
23,NOV,2017,INTERNATIONAL FLIGHTS,11,13,24
24,NOV,2017,INTERNATIONAL FLIGHTS,6,7,13
25,NOV,2017,INTERNATIONAL FLIGHTS,22,17,39
26,NOV,2017,INTERNATIONAL FLIGHTS,21,20,41
27,NOV,2017,INTERNATIONAL FLIGHTS,9,11,20
28,NOV,2017,INTERNATIONAL FLIGHTS,11,12,23
29,NOV,2017,INTERNATIONAL FLIGHTS,28,24,52
30,NOV,2017,INTERNATIONAL FLIGHTS,12,14,26
1,NOV,2017,LOCAL FLIGHTS,1,1,2
2,NOV,2017,LOCAL FLIGHTS,1,1,2
3,NOV,2017,LOCAL FLIGHTS,1,1,2
4,NOV,2017,LOCAL FLIGHTS,2,2,4
5,NOV,2017,LOCAL FLIGHTS,0,0,0
6,NOV,2017,LOCAL FLIGHTS,0,0,0
7,NOV,2017,LOCAL FLIGHTS,2,2,4
8,NOV,2017,LOCAL FLIGHTS,2,2,4
9,NOV,2017,LOCAL FLIGHTS,0,0,0
10,NOV,2017,LOCAL FLIGHTS,2,2,4
11,NOV,2017,LOCAL FLIGHTS,2,2,4
12,NOV,2017,LOCAL FLIGHTS,1,1,2
13,NOV,2017,LOCAL FLIGHTS,1,1,2
14,NOV,2017,LOCAL FLIGHTS,3,3,6
15,NOV,2017,LOCAL FLIGHTS,1,1,2
16,NOV,2017,LOCAL FLIGHTS,3,3,6
17,NOV,2017,LOCAL FLIGHTS,5,5,10
18,NOV,2017,LOCAL FLIGHTS,4,4,8
19,NOV,2017,LOCAL FLIGHTS,0,0,0
20,NOV,2017,LOCAL FLIGHTS,0,0,0
21,NOV,2017,LOCAL FLIGHTS,2,2,4
22,NOV,2017,LOCAL FLIGHTS,3,3,6
23,NOV,2017,LOCAL FLIGHTS,1,1,2
24,NOV,2017,LOCAL FLIGHTS,1,1,2
25,NOV,2017,LOCAL FLIGHTS,2,2,4
26,NOV,2017,LOCAL FLIGHTS,1,1,2
27,NOV,2017,LOCAL FLIGHTS,0,0,0
28,NOV,2017,LOCAL FLIGHTS,0,0,0
29,NOV,2017,LOCAL FLIGHTS,2,2,4
30,NOV,2017,LOCAL FLIGHTS,0,0,0
1,NOV,2017,HELICOPTER FLIGHTS,7,7,14
2,NOV,2017,HELICOPTER FLIGHTS,11,11,22
3,NOV,2017,HELICOPTER FLIGHTS,9,9,18
4,NOV,2017,HELICOPTER FLIGHTS,0,0,0
5,NOV,2017,HELICOPTER FLIGHTS,0,0,0
6,NOV,2017,HELICOPTER FLIGHTS,5,5,10
7,NOV,2017,HELICOPTER FLIGHTS,7,7,14
8,NOV,2017,HELICOPTER FLIGHTS,6,6,12
9,NOV,2017,HELICOPTER FLIGHTS,5,5,10
10,NOV,2017,HELICOPTER FLIGHTS,6,6,12
11,NOV,2017,HELICOPTER FLIGHTS,3,3,6
12,NOV,2017,HELICOPTER FLIGHTS,0,0,0
13,NOV,2017,HELICOPTER FLIGHTS,3,3,6
14,NOV,2017,HELICOPTER FLIGHTS,8,8,16
15,NOV,2017,HELICOPTER FLIGHTS,4,4,8
16,NOV,2017,HELICOPTER FLIGHTS,4,4,8
17,NOV,2017,HELICOPTER FLIGHTS,0,0,0
18,NOV,2017,HELICOPTER FLIGHTS,0,0,0
19,NOV,2017,HELICOPTER FLIGHTS,0,0,0
20,NOV,2017,HELICOPTER FLIGHTS,5,5,10
21,NOV,2017,HELICOPTER FLIGHTS,0,0,0
22,NOV,2017,HELICOPTER FLIGHTS,3,3,6
23,NOV,2017,HELICOPTER FLIGHTS,9,9,18
24,NOV,2017,HELICOPTER FLIGHTS,2,2,4
25,NOV,2017,HELICOPTER FLIGHTS,0,0,0
26,NOV,2017,HELICOPTER FLIGHTS,0,0,0
27,NOV,2017,HELICOPTER FLIGHTS,4,4,8
28,NOV,2017,HELICOPTER FLIGHTS,6,6,12
29,NOV,2017,HELICOPTER FLIGHTS,14,14,28
30,NOV,2017,HELICOPTER FLIGHTS,17,17,34
1,DEC,2017,INTERNATIONAL FLIGHTS,7,9,16
2,DEC,2017,INTERNATIONAL FLIGHTS,18,15,33
3,DEC,2017,INTERNATIONAL FLIGHTS,38,41,79
4,DEC,2017,INTERNATIONAL FLIGHTS,36,34,70
5,DEC,2017,INTERNATIONAL FLIGHTS,35,30,65
6,DEC,2017,INTERNATIONAL FLIGHTS,57,58,115
7,DEC,2017,INTERNATIONAL FLIGHTS,15,19,34
8,DEC,2017,INTERNATIONAL FLIGHTS,10,9,19
9,DEC,2017,INTERNATIONAL FLIGHTS,14,13,27
10,DEC,2017,INTERNATIONAL FLIGHTS,15,19,34
11,DEC,2017,INTERNATIONAL FLIGHTS,11,8,19
12,DEC,2017,INTERNATIONAL FLIGHTS,14,12,26
13,DEC,2017,INTERNATIONAL FLIGHTS,23,25,48
14,DEC,2017,INTERNATIONAL FLIGHTS,10,13,23
15,DEC,2017,INTERNATIONAL FLIGHTS,7,8,15
16,DEC,2017,INTERNATIONAL FLIGHTS,20,16,36
17,DEC,2017,INTERNATIONAL FLIGHTS,15,19,34
18,DEC,2017,INTERNATIONAL FLIGHTS,11,9,20
19,DEC,2017,INTERNATIONAL FLIGHTS,10,11,21
20,DEC,2017,INTERNATIONAL FLIGHTS,26,23,49
21,DEC,2017,INTERNATIONAL FLIGHTS,12,12,24
22,DEC,2017,INTERNATIONAL FLIGHTS,4,9,13
23,DEC,2017,INTERNATIONAL FLIGHTS,14,13,27
24,DEC,2017,INTERNATIONAL FLIGHTS,12,13,25
25,DEC,2017,INTERNATIONAL FLIGHTS,2,1,3
26,DEC,2017,INTERNATIONAL FLIGHTS,9,8,17
27,DEC,2017,INTERNATIONAL FLIGHTS,22,19,41
28,DEC,2017,INTERNATIONAL FLIGHTS,14,17,31
29,DEC,2017,INTERNATIONAL FLIGHTS,8,6,14
30,DEC,2017,INTERNATIONAL FLIGHTS,12,14,26
31,DEC,2017,INTERNATIONAL FLIGHTS,12,12,24
1,DEC,2017,LOCAL FLIGHTS,4,5,9
2,DEC,2017,LOCAL FLIGHTS,5,5,10
3,DEC,2017,LOCAL FLIGHTS,0,0,0
4,DEC,2017,LOCAL FLIGHTS,0,0,0
5,DEC,2017,LOCAL FLIGHTS,0,0,0
6,DEC,2017,LOCAL FLIGHTS,0,0,0
7,DEC,2017,LOCAL FLIGHTS,1,1,2
8,DEC,2017,LOCAL FLIGHTS,2,2,4
9,DEC,2017,LOCAL FLIGHTS,0,0,0
10,DEC,2017,LOCAL FLIGHTS,0,0,0
11,DEC,2017,LOCAL FLIGHTS,0,0,0
12,DEC,2017,LOCAL FLIGHTS,1,1,2
13,DEC,2017,LOCAL FLIGHTS,2,2,4
14,DEC,2017,LOCAL FLIGHTS,1,1,2
15,DEC,2017,LOCAL FLIGHTS,0,0,0
16,DEC,2017,LOCAL FLIGHTS,4,4,8
17,DEC,2017,LOCAL FLIGHTS,0,0,0
18,DEC,2017,LOCAL FLIGHTS,0,0,0
19,DEC,2017,LOCAL FLIGHTS,2,2,4
20,DEC,2017,LOCAL FLIGHTS,0,0,0
21,DEC,2017,LOCAL FLIGHTS,0,0,0
22,DEC,2017,LOCAL FLIGHTS,1,1,2
23,DEC,2017,LOCAL FLIGHTS,1,1,2
24,DEC,2017,LOCAL FLIGHTS,1,1,2
25,DEC,2017,LOCAL FLIGHTS,0,0,0
26,DEC,2017,LOCAL FLIGHTS,0,0,0
27,DEC,2017,LOCAL FLIGHTS,1,1,2
28,DEC,2017,LOCAL FLIGHTS,2,2,4
29,DEC,2017,LOCAL FLIGHTS,5,5,10
30,DEC,2017,LOCAL FLIGHTS,3,4,7
31,DEC,2017,LOCAL FLIGHTS,0,0,0
1,DEC,2017,HELICOPTER FLIGHTS,1,1,2
2,DEC,2017,HELICOPTER FLIGHTS,0,0,0
3,DEC,2017,HELICOPTER FLIGHTS,1,1,2
4,DEC,2017,HELICOPTER FLIGHTS,10,10,20
5,DEC,2017,HELICOPTER FLIGHTS,6,6,12
6,DEC,2017,HELICOPTER FLIGHTS,6,6,12
7,DEC,2017,HELICOPTER FLIGHTS,10,10,20
8,DEC,2017,HELICOPTER FLIGHTS,0,0,0
9,DEC,2017,HELICOPTER FLIGHTS,0,0,0
10,DEC,2017,HELICOPTER FLIGHTS,0,0,0
11,DEC,2017,HELICOPTER FLIGHTS,0,0,0
12,DEC,2017,HELICOPTER FLIGHTS,12,12,24
13,DEC,2017,HELICOPTER FLIGHTS,12,12,24
14,DEC,2017,HELICOPTER FLIGHTS,20,20,40
15,DEC,2017,HELICOPTER FLIGHTS,0,0,0
16,DEC,2017,HELICOPTER FLIGHTS,0,0,0
17,DEC,2017,HELICOPTER FLIGHTS,0,0,0
18,DEC,2017,HELICOPTER FLIGHTS,0,0,0
19,DEC,2017,HELICOPTER FLIGHTS,10,10,20
20,DEC,2017,HELICOPTER FLIGHTS,9,9,18
21,DEC,2017,HELICOPTER FLIGHTS,23,23,46
22,DEC,2017,HELICOPTER FLIGHTS,0,0,0
23,DEC,2017,HELICOPTER FLIGHTS,0,0,0
24,DEC,2017,HELICOPTER FLIGHTS,0,0,0
25,DEC,2017,HELICOPTER FLIGHTS,0,0,0
26,DEC,2017,HELICOPTER FLIGHTS,0,0,0
27,DEC,2017,HELICOPTER FLIGHTS,6,6,12
28,DEC,2017,HELICOPTER FLIGHTS,9,9,18
29,DEC,2017,HELICOPTER FLIGHTS,0,0,0
30,DEC,2017,HELICOPTER FLIGHTS,0,0,0
31,DEC,2017,HELICOPTER FLIGHTS,0,0,0
